Team,Opp Team,Game Date,Days Btwn Games,GF/GP,GA/GP,Net Goals,Shots For,Shots Against,Shot Diff,PP Opp/GP,TS/GP,PP%,PK%,FOW%,Home,Winner
New Jersey Devils,Buffalo Sabres,2024-10-04,4,4,1,3,23,31,-8,2,4,0.0,100.0,42.4,0,New Jersey Devils
Buffalo Sabres,New Jersey Devils,2024-10-04,4,1,4,-3,31,23,8,4,2,0.0,100.0,57.6,1,New Jersey Devils
New Jersey Devils,Buffalo Sabres,2024-10-05,0,3,1,2,37,18,19,4,2,25.0,100.0,64.7,1,New Jersey Devils
Buffalo Sabres,New Jersey Devils,2024-10-05,0,1,3,-2,18,37,-19,2,4,0.0,75.0,35.3,0,New Jersey Devils
Boston Bruins,Florida Panthers,2024-10-08,4,4,6,-2,28,35,-7,4,6,25.0,100.0,48.4,0,Florida Panthers
Florida Panthers,Boston Bruins,2024-10-08,4,6,4,2,35,28,7,6,4,0.0,75.0,51.6,1,Florida Panthers
Chicago Blackhawks,Utah Hockey Club,2024-10-08,4,2,5,-3,26,27,-1,3,1,0.0,100.0,50.0,0,Utah Hockey Club
St. Louis Blues,Seattle Kraken,2024-10-08,4,3,2,1,25,32,-7,2,1,50.0,100.0,56.3,0,St. Louis Blues
Seattle Kraken,St. Louis Blues,2024-10-08,4,2,3,-1,32,25,7,1,2,0.0,50.0,43.7,1,St. Louis Blues
Utah Hockey Club,Chicago Blackhawks,2024-10-08,4,5,2,3,27,26,1,1,3,0.0,100.0,50.0,1,Utah Hockey Club
New York Rangers,Pittsburgh Penguins,2024-10-09,4,6,0,6,40,31,9,2,3,0.0,100.0,54.2,0,New York Rangers
Pittsburgh Penguins,New York Rangers,2024-10-09,4,0,6,-6,31,40,-9,3,2,0.0,100.0,45.8,1,New York Rangers
Montréal Canadiens,Toronto Maple Leafs,2024-10-09,4,1,0,1,27,48,-21,5,4,20.0,100.0,33.3,0,Montréal Canadiens
Toronto Maple Leafs,Montreal Canadiens,2024-10-09,4,0,1,-1,48,27,21,4,5,0.0,80.0,66.7,0,Montreal Canadiens
Calgary Flames,Vancouver Canucks,2024-10-09,4,6,5,1,26,24,2,3,4,33.3,50.0,46.2,0,Calgary Flames
Colorado Avalanche,Vegas Golden Knights,2024-10-09,4,4,8,-4,32,21,11,3,3,33.3,33.3,42.0,0,Vegas Golden Knights
Edmonton Oilers,Winnipeg Jets,2024-10-09,4,0,6,-6,30,20,10,1,3,0.0,33.3,59.2,1,Winnipeg Jets
Vancouver Canucks,Calgary Flames,2024-10-09,4,5,6,-1,24,26,-2,4,3,50.0,66.7,53.9,1,Calgary Flames
Winnipeg Jets,Edmonton Oilers,2024-10-09,4,6,0,6,20,30,-10,3,1,66.7,100.0,40.8,0,Winnipeg Jets
Vegas Golden Knights,Colorado Avalanche,2024-10-09,4,8,4,4,21,32,-11,3,3,66.7,66.7,58.0,1,Vegas Golden Knights
New Jersey Devils,Toronto Maple Leafs,2024-10-10,4,2,4,-2,23,22,1,5,2,20.0,100.0,51.9,1,Toronto Maple Leafs
New York Islanders,Utah Hockey Club,2024-10-10,4,4,5,-1,27,26,1,6,2,16.7,0.0,47.8,1,Utah Hockey Club
Pittsburgh Penguins,Detroit Red Wings,2024-10-10,0,6,3,3,28,32,-4,2,5,50.0,80.0,53.6,0,Pittsburgh Penguins
Boston Bruins,Montreal Canadiens,2024-10-10,1,6,4,2,29,24,5,5,6,20.0,83.3,50.0,1,Boston Bruins
Buffalo Sabres,Los Angeles Kings,2024-10-10,4,1,3,-2,33,23,10,5,5,0.0,80.0,58.3,1,Los Angeles Kings
Montréal Canadiens,Boston Bruins,2024-10-10,0,4,6,-2,24,29,-5,6,5,16.7,80.0,50.0,0,Boston Bruins
Ottawa Senators,Florida Panthers,2024-10-10,4,3,1,2,31,32,-1,3,2,33.3,100.0,56.1,1,Ottawa Senators
Toronto Maple Leafs,New Jersey Devils,2024-10-10,0,4,2,2,22,23,-1,2,5,0.0,80.0,48.2,0,Toronto Maple Leafs
Florida Panthers,Ottawa Senators,2024-10-10,1,1,3,-2,32,31,1,2,3,0.0,66.7,43.9,0,Ottawa Senators
Detroit Red Wings,Pittsburgh Penguins,2024-10-10,4,3,6,-3,32,28,4,5,2,20.0,50.0,46.4,1,Pittsburgh Penguins
Nashville Predators,Dallas Stars,2024-10-10,4,3,4,-1,36,20,16,6,4,16.7,75.0,65.5,1,Dallas Stars
St. Louis Blues,San Jose Sharks,2024-10-10,1,5,4,1,40,29,11,2,2,0.0,50.0,58.3,0,St. Louis Blues
Dallas Stars,Nashville Predators,2024-10-10,4,4,3,1,20,36,-16,4,6,25.0,83.3,34.5,0,Dallas Stars
Los Angeles Kings,Buffalo Sabres,2024-10-10,4,3,1,2,23,33,-10,5,5,20.0,100.0,41.7,0,Los Angeles Kings
San Jose Sharks,St. Louis Blues,2024-10-10,4,4,5,-1,29,40,-11,2,2,50.0,100.0,41.7,1,St. Louis Blues
Columbus Blue Jackets,Minnesota Wild,2024-10-10,4,2,3,-1,33,26,7,3,3,33.3,66.7,45.8,0,Minnesota Wild
Minnesota Wild,Columbus Blue Jackets,2024-10-10,4,3,2,1,26,33,-7,3,3,33.3,66.7,54.2,1,Minnesota Wild
Utah Hockey Club,New York Islanders,2024-10-10,1,5,4,1,26,27,-1,2,6,100.0,83.3,52.2,0,Utah Hockey Club
Philadelphia Flyers,Vancouver Canucks,2024-10-11,4,2,2,0,31,26,5,4,5,25.0,100.0,42.2,0,Vancouver Canucks
Carolina Hurricanes,Tampa Bay Lightning,2024-10-11,4,1,4,-3,21,23,-2,4,6,0.0,66.7,53.0,1,Tampa Bay Lightning
Tampa Bay Lightning,Carolina Hurricanes,2024-10-11,4,4,1,3,23,21,2,6,4,33.3,100.0,47.0,0,Tampa Bay Lightning
Chicago Blackhawks,Winnipeg Jets,2024-10-11,2,1,2,-1,26,35,-9,1,2,0.0,100.0,36.7,0,Winnipeg Jets
St. Louis Blues,Vegas Golden Knights,2024-10-11,0,3,4,-1,22,28,-6,2,2,50.0,100.0,52.8,0,Vegas Golden Knights
Vancouver Canucks,Philadelphia Flyers,2024-10-11,1,2,2,0,26,31,-5,5,4,0.0,75.0,57.8,1,Philadelphia Flyers
Winnipeg Jets,Chicago Blackhawks,2024-10-11,1,2,1,1,35,26,9,2,1,0.0,100.0,63.3,1,Winnipeg Jets
Vegas Golden Knights,St. Louis Blues,2024-10-11,1,4,3,1,28,22,6,2,2,0.0,50.0,47.2,1,Vegas Golden Knights
New Jersey Devils,Washington Capitals,2024-10-12,1,5,3,2,33,32,1,4,3,0.0,66.7,58.2,0,New Jersey Devils
New York Islanders,Dallas Stars,2024-10-12,1,0,3,-3,34,27,7,1,2,0.0,100.0,50.9,0,Dallas Stars
New York Rangers,Utah Hockey Club,2024-10-12,2,5,6,-1,34,26,8,3,4,33.3,75.0,56.9,1,Utah Hockey Club
Philadelphia Flyers,Calgary Flames,2024-10-12,0,3,6,-3,40,32,8,4,5,25.0,60.0,54.6,0,Calgary Flames
Pittsburgh Penguins,Toronto Maple Leafs,2024-10-12,1,2,4,-2,23,33,-10,4,3,25.0,100.0,46.8,0,Toronto Maple Leafs
Boston Bruins,Los Angeles Kings,2024-10-12,1,2,1,1,26,34,-8,5,5,0.0,100.0,55.1,1,Boston Bruins
Buffalo Sabres,Florida Panthers,2024-10-12,1,5,2,3,27,25,2,3,2,0.0,50.0,51.6,1,Buffalo Sabres
Montréal Canadiens,Ottawa Senators,2024-10-12,1,4,1,3,26,25,1,4,4,25.0,100.0,54.6,0,Montréal Canadiens
Ottawa Senators,Montreal Canadiens,2024-10-12,1,1,4,-3,25,26,-1,4,4,0.0,75.0,45.5,0,Montreal Canadiens
Toronto Maple Leafs,Pittsburgh Penguins,2024-10-12,1,4,2,2,33,23,10,3,4,0.0,75.0,53.2,1,Toronto Maple Leafs
Florida Panthers,Buffalo Sabres,2024-10-12,1,2,5,-3,25,27,-2,2,3,50.0,100.0,48.4,0,Buffalo Sabres
Washington Capitals,New Jersey Devils,2024-10-12,4,3,5,-2,32,33,-1,3,4,33.3,100.0,41.8,1,New Jersey Devils
Chicago Blackhawks,Edmonton Oilers,2024-10-12,0,5,2,3,20,38,-18,3,3,100.0,66.7,39.7,0,Chicago Blackhawks
Detroit Red Wings,Nashville Predators,2024-10-12,1,3,0,3,22,42,-20,2,3,0.0,100.0,45.5,1,Detroit Red Wings
Nashville Predators,Detroit Red Wings,2024-10-12,1,0,3,-3,42,22,20,3,2,0.0,100.0,54.6,0,Detroit Red Wings
Calgary Flames,Philadelphia Flyers,2024-10-12,2,6,3,3,32,40,-8,5,4,40.0,75.0,45.5,1,Calgary Flames
Colorado Avalanche,Columbus Blue Jackets,2024-10-12,2,4,6,-2,30,23,7,4,3,50.0,66.7,56.3,1,Columbus Blue Jackets
Edmonton Oilers,Chicago Blackhawks,2024-10-12,2,2,5,-3,38,20,18,3,3,33.3,0.0,60.3,1,Chicago Blackhawks
Anaheim Ducks,San Jose Sharks,2024-10-12,4,2,0,2,30,30,0,5,3,0.0,100.0,45.6,0,Anaheim Ducks
Dallas Stars,New York Islanders,2024-10-12,1,3,0,3,27,34,-7,2,1,0.0,100.0,49.1,1,Dallas Stars
Los Angeles Kings,Boston Bruins,2024-10-12,1,1,2,-1,34,26,8,5,5,0.0,100.0,44.9,0,Boston Bruins
San Jose Sharks,Anaheim Ducks,2024-10-12,1,0,2,-2,30,30,0,3,5,0.0,100.0,54.4,1,Anaheim Ducks
Columbus Blue Jackets,Colorado Avalanche,2024-10-12,1,6,4,2,23,30,-7,3,4,33.3,50.0,43.8,0,Columbus Blue Jackets
Minnesota Wild,Seattle Kraken,2024-10-12,1,4,4,0,38,34,4,2,2,50.0,50.0,50.8,1,Seattle Kraken
Seattle Kraken,Minnesota Wild,2024-10-12,3,4,4,0,34,38,-4,2,2,50.0,50.0,49.2,0,Minnesota Wild
Utah Hockey Club,New York Rangers,2024-10-12,1,6,5,1,26,34,-8,4,3,25.0,66.7,43.1,0,Utah Hockey Club
Calgary Flames,Edmonton Oilers,2024-10-13,0,4,1,3,29,26,3,3,1,0.0,100.0,44.2,0,Calgary Flames
Edmonton Oilers,Calgary Flames,2024-10-13,0,1,4,-3,26,29,-3,1,3,0.0,100.0,55.8,1,Calgary Flames
Anaheim Ducks,Vegas Golden Knights,2024-10-13,0,1,3,-2,23,32,-9,1,4,0.0,75.0,46.5,0,Vegas Golden Knights
Dallas Stars,Seattle Kraken,2024-10-13,0,2,0,2,23,25,-2,3,4,0.0,100.0,51.9,1,Dallas Stars
Minnesota Wild,Winnipeg Jets,2024-10-13,0,1,2,-1,27,35,-8,3,2,0.0,50.0,47.5,0,Winnipeg Jets
Winnipeg Jets,Minnesota Wild,2024-10-13,1,2,1,1,35,27,8,2,3,50.0,100.0,52.5,1,Winnipeg Jets
Vegas Golden Knights,Anaheim Ducks,2024-10-13,1,3,1,2,32,23,9,4,1,25.0,100.0,53.5,1,Vegas Golden Knights
Seattle Kraken,Dallas Stars,2024-10-13,0,0,2,-2,25,23,2,4,3,0.0,100.0,48.1,0,Dallas Stars
New Jersey Devils,Utah Hockey Club,2024-10-14,1,3,0,3,32,20,12,7,4,28.6,100.0,43.2,1,New Jersey Devils
New York Islanders,Colorado Avalanche,2024-10-14,1,6,2,4,37,34,3,1,2,0.0,100.0,56.8,0,New York Islanders
New York Rangers,Detroit Red Wings,2024-10-14,1,4,1,3,28,32,-4,5,4,20.0,100.0,58.2,1,New York Rangers
Pittsburgh Penguins,Montreal Canadiens,2024-10-14,1,6,3,3,30,28,2,1,2,0.0,50.0,64.6,0,Pittsburgh Penguins
Boston Bruins,Florida Panthers,2024-10-14,1,3,4,-1,27,26,1,4,5,0.0,80.0,54.1,1,Florida Panthers
Montréal Canadiens,Pittsburgh Penguins,2024-10-14,1,3,6,-3,28,30,-2,2,1,50.0,100.0,35.4,0,Pittsburgh Penguins
Ottawa Senators,Los Angeles Kings,2024-10-14,1,8,7,1,41,26,15,6,5,66.7,40.0,44.1,1,Ottawa Senators
Florida Panthers,Boston Bruins,2024-10-14,1,4,3,1,26,27,-1,5,4,20.0,100.0,45.9,0,Florida Panthers
Detroit Red Wings,New York Rangers,2024-10-14,1,1,4,-3,32,28,4,4,5,0.0,80.0,41.8,0,New York Rangers
Colorado Avalanche,New York Islanders,2024-10-14,1,2,6,-4,34,37,-3,2,1,0.0,100.0,43.2,1,New York Islanders
Los Angeles Kings,Ottawa Senators,2024-10-14,1,7,8,-1,26,41,-15,5,6,60.0,33.3,55.9,0,Ottawa Senators
Utah Hockey Club,New Jersey Devils,2024-10-14,1,0,3,-3,20,32,-12,4,7,0.0,71.4,56.8,0,New Jersey Devils
New Jersey Devils,Carolina Hurricanes,2024-10-15,0,2,4,-2,26,31,-5,3,1,33.3,100.0,44.4,0,Carolina Hurricanes
Philadelphia Flyers,Edmonton Oilers,2024-10-15,2,3,4,-1,30,31,-1,7,4,28.6,100.0,40.9,0,Edmonton Oilers
Carolina Hurricanes,New Jersey Devils,2024-10-15,3,4,2,2,31,26,5,1,3,0.0,66.7,55.6,1,Carolina Hurricanes
Florida Panthers,Columbus Blue Jackets,2024-10-15,0,4,3,1,22,38,-16,3,2,0.0,100.0,42.6,0,Florida Panthers
Tampa Bay Lightning,Vancouver Canucks,2024-10-15,3,4,1,3,27,27,0,5,3,0.0,66.7,45.1,1,Tampa Bay Lightning
Washington Capitals,Vegas Golden Knights,2024-10-15,2,4,2,2,22,26,-4,3,4,33.3,75.0,54.6,1,Washington Capitals
Chicago Blackhawks,Calgary Flames,2024-10-15,2,1,3,-2,32,27,5,2,3,0.0,66.7,51.5,0,Calgary Flames
Nashville Predators,Seattle Kraken,2024-10-15,2,3,7,-4,33,35,-2,2,2,0.0,100.0,58.7,1,Seattle Kraken
St. Louis Blues,Minnesota Wild,2024-10-15,3,1,4,-3,28,27,1,2,5,0,60.0,55.3,1,Minnesota Wild
Calgary Flames,Chicago Blackhawks,2024-10-15,1,3,1,2,27,32,-5,3,2,33.3,100.0,48.5,1,Calgary Flames
Edmonton Oilers,Philadelphia Flyers,2024-10-15,1,4,3,1,31,30,1,4,7,0,71.4,59.1,1,Edmonton Oilers
Vancouver Canucks,Tampa Bay Lightning,2024-10-15,3,1,4,-3,27,27,0,3,5,33.3,100.0,54.9,0,Tampa Bay Lightning
Dallas Stars,San Jose Sharks,2024-10-15,1,2,2,0,38,27,11,4,3,0,100.0,52.6,1,San Jose Sharks
San Jose Sharks,Dallas Stars,2024-10-15,2,2,2,0,27,38,-11,3,4,0,100.0,47.4,0,Dallas Stars
Columbus Blue Jackets,Florida Panthers,2024-10-15,2,3,4,-1,38,22,16,2,3,0,100.0,57.4,1,Florida Panthers
Minnesota Wild,St. Louis Blues,2024-10-15,1,4,1,3,27,28,-1,5,2,40,100.0,44.7,0,Minnesota Wild
Vegas Golden Knights,Washington Capitals,2024-10-15,1,2,4,-2,26,22,4,4,3,25,66.7,45.5,0,Washington Capitals
Seattle Kraken,Nashville Predators,2024-10-15,1,7,3,4,35,33,2,2,2,0,100.0,41.3,0,Seattle Kraken
Pittsburgh Penguins,Buffalo Sabres,2024-10-16,1,6,5,1,43,33,10,5,1,40,100.0,62.1,1,Pittsburgh Penguins
Boston Bruins,Colorado Avalanche,2024-10-16,1,5,3,2,26,25,1,4,3,50,0.0,61.3,0,Boston Bruins
Buffalo Sabres,Pittsburgh Penguins,2024-10-16,3,5,6,-1,33,43,-10,1,5,0,60.0,37.9,0,Pittsburgh Penguins
Toronto Maple Leafs,Los Angeles Kings,2024-10-16,3,6,2,4,26,34,-8,4,4,50,100.0,55.0,1,Toronto Maple Leafs
Colorado Avalanche,Boston Bruins,2024-10-16,1,3,5,-2,25,26,-1,3,4,100,50.0,38.7,1,Boston Bruins
Anaheim Ducks,Utah Hockey Club,2024-10-16,2,5,4,1,34,30,4,5,2,0,50.0,38.2,1,Anaheim Ducks
Los Angeles Kings,Toronto Maple Leafs,2024-10-16,1,2,6,-4,34,26,8,4,4,0,50.0,45.0,0,Toronto Maple Leafs
Utah Hockey Club,Anaheim Ducks,2024-10-16,1,4,5,-1,30,34,-4,2,5,50,100.0,61.8,0,Anaheim Ducks
New Jersey Devils,Ottawa Senators,2024-10-17,1,3,1,2,35,31,4,2,3,0,66.7,47.9,0,New Jersey Devils
New York Islanders,St. Louis Blues,2024-10-17,2,0,1,-1,34,30,4,2,1,0,100.0,53.3,0,St. Louis Blues
New York Rangers,Detroit Red Wings,2024-10-17,2,5,2,3,34,31,3,4,5,75,80.0,55.4,0,New York Rangers
Philadelphia Flyers,Seattle Kraken,2024-10-17,1,4,6,-2,25,29,-4,4,5,25,80.0,54.4,0,Seattle Kraken
Buffalo Sabres,Columbus Blue Jackets,2024-10-17,0,4,6,-2,24,25,-1,2,3,0,66.7,50.9,0,Columbus Blue Jackets
Montréal Canadiens,Los Angeles Kings,2024-10-17,2,1,4,-3,27,32,-5,5,2,0,100.0,59.3,0,Los Angeles Kings
Ottawa Senators,New Jersey Devils,2024-10-17,2,1,3,-2,31,35,-4,3,2,33.3,100.0,52.1,1,New Jersey Devils
Florida Panthers,Vancouver Canucks,2024-10-17,1,2,3,-1,28,33,-5,1,2,100,100.0,50.8,1,Vancouver Canucks
Tampa Bay Lightning,Vegas Golden Knights,2024-10-17,1,4,3,1,25,25,0,2,3,0,66.7,43.5,1,Tampa Bay Lightning
Washington Capitals,Dallas Stars,2024-10-17,1,3,2,1,26,24,2,5,4,0,100.0,47.5,1,Washington Capitals
Chicago Blackhawks,San Jose Sharks,2024-10-17,1,4,2,2,27,22,5,7,3,28.6,100.0,44.1,1,Chicago Blackhawks
Detroit Red Wings,New York Rangers,2024-10-17,2,2,5,-3,31,34,-3,5,4,20,25.0,44.6,1,New York Rangers
Nashville Predators,Edmonton Oilers,2024-10-17,1,2,4,-2,27,36,-9,3,4,33.3,100.0,54.6,1,Edmonton Oilers
St. Louis Blues,New York Islanders,2024-10-17,1,1,0,1,30,34,-4,1,2,0,100.0,46.7,1,St. Louis Blues
Edmonton Oilers,Nashville Predators,2024-10-17,1,4,2,2,36,27,9,4,3,0,66.7,45.5,0,Edmonton Oilers
Vancouver Canucks,Florida Panthers,2024-10-17,1,3,2,1,33,28,5,2,1,0,0.0,49.2,0,Vancouver Canucks
Dallas Stars,Washington Capitals,2024-10-17,1,2,3,-1,24,26,-2,4,5,0,100.0,52.5,0,Washington Capitals
Los Angeles Kings,Montreal Canadiens,2024-10-17,0,4,1,3,32,27,5,2,5,0,100.0,40.7,0,Los Angeles Kings
San Jose Sharks,Chicago Blackhawks,2024-10-17,1,2,4,-2,22,27,-5,3,7,0,71.4,55.9,0,Chicago Blackhawks
Columbus Blue Jackets,Buffalo Sabres,2024-10-17,1,6,4,2,25,24,1,3,2,33.3,100.0,49.1,1,Columbus Blue Jackets
Vegas Golden Knights,Tampa Bay Lightning,2024-10-17,1,3,4,-1,25,25,0,3,2,33.3,100.0,56.5,0,Tampa Bay Lightning
Seattle Kraken,Philadelphia Flyers,2024-10-17,1,6,4,2,29,25,4,5,4,20,75.0,45.6,1,Seattle Kraken
Pittsburgh Penguins,Carolina Hurricanes,2024-10-18,1,1,4,-3,26,38,-12,5,4,0,50.0,52.6,1,Carolina Hurricanes
Carolina Hurricanes,Pittsburgh Penguins,2024-10-18,2,4,1,3,38,26,12,4,5,50,100.0,47.4,0,Carolina Hurricanes
Colorado Avalanche,Anaheim Ducks,2024-10-18,1,4,3,1,49,19,30,5,3,20,100.0,61.0,1,Colorado Avalanche
Anaheim Ducks,Colorado Avalanche,2024-10-18,1,3,4,-1,19,49,-30,3,5,0,80.0,39.0,0,Colorado Avalanche
San Jose Sharks,Winnipeg Jets,2024-10-18,0,3,8,-5,22,36,-14,2,7,50,42.9,49.1,0,Winnipeg Jets
Winnipeg Jets,San Jose Sharks,2024-10-18,4,8,3,5,36,22,14,7,2,57.1,50.0,50.9,1,Winnipeg Jets
New Jersey Devils,Washington Capitals,2024-10-19,1,5,6,-1,31,37,-6,2,2,50,100.0,57.6,1,Washington Capitals
New York Islanders,Montreal Canadiens,2024-10-19,1,3,3,0,36,24,12,6,1,16.7,0.0,52.7,1,Montreal Canadiens
New York Rangers,Toronto Maple Leafs,2024-10-19,1,4,1,3,29,35,-6,2,3,0,100.0,47.1,0,New York Rangers
Philadelphia Flyers,Vancouver Canucks,2024-10-19,1,0,3,-3,26,32,-6,3,2,0,100.0,50.9,1,Vancouver Canucks
Boston Bruins,Utah Hockey Club,2024-10-19,2,1,2,-1,22,32,-10,3,4,0,100.0,46.9,0,Utah Hockey Club
Buffalo Sabres,Chicago Blackhawks,2024-10-19,1,4,2,2,22,37,-15,4,1,0,100.0,46.3,0,Buffalo Sabres
Montréal Canadiens,New York Islanders,2024-10-19,1,3,3,0,24,36,-12,1,6,100,83.3,47.3,0,New York Islanders
Ottawa Senators,Tampa Bay Lightning,2024-10-19,1,5,4,1,28,29,-1,5,3,40,100.0,46.3,1,Ottawa Senators
Toronto Maple Leafs,New York Rangers,2024-10-19,2,1,4,-3,35,29,6,3,2,0,100.0,52.9,1,New York Rangers
Carolina Hurricanes,St. Louis Blues,2024-10-19,0,3,4,-1,40,19,21,3,4,33.3,100.0,46.5,0,St. Louis Blues
Florida Panthers,Vegas Golden Knights,2024-10-19,1,4,3,1,49,26,23,2,1,50,100.0,43.3,1,Florida Panthers
Tampa Bay Lightning,Ottawa Senators,2024-10-19,1,4,5,-1,29,28,1,3,5,0,60.0,53.7,0,Ottawa Senators
Washington Capitals,New Jersey Devils,2024-10-19,1,6,5,1,37,31,6,2,2,0,50.0,42.4,0,Washington Capitals
Chicago Blackhawks,Buffalo Sabres,2024-10-19,1,2,4,-2,37,22,15,1,4,0,100.0,53.7,1,Buffalo Sabres
Detroit Red Wings,Nashville Predators,2024-10-19,1,5,2,3,24,39,-15,3,2,33.3,50.0,54.0,0,Detroit Red Wings
Nashville Predators,Detroit Red Wings,2024-10-19,1,2,5,-3,39,24,15,2,3,50,66.7,46.0,1,Detroit Red Wings
St. Louis Blues,Carolina Hurricanes,2024-10-19,1,4,3,1,19,40,-21,4,3,0,66.7,53.5,1,St. Louis Blues
Calgary Flames,Seattle Kraken,2024-10-19,3,1,2,-1,22,23,-1,3,6,33.3,83.3,44.3,0,Seattle Kraken
Edmonton Oilers,Dallas Stars,2024-10-19,1,1,4,-3,31,24,7,2,1,0,0.0,62.9,0,Dallas Stars
Vancouver Canucks,Philadelphia Flyers,2024-10-19,1,3,0,3,32,26,6,2,3,0,100.0,49.1,0,Vancouver Canucks
Dallas Stars,Edmonton Oilers,2024-10-19,1,4,1,3,24,31,-7,1,2,100,100.0,37.1,1,Dallas Stars
Columbus Blue Jackets,Minnesota Wild,2024-10-19,1,1,3,-2,24,34,-10,3,3,0,66.7,55.3,1,Minnesota Wild
Minnesota Wild,Columbus Blue Jackets,2024-10-19,3,3,1,2,34,24,10,3,3,33.3,100.0,44.7,0,Minnesota Wild
Vegas Golden Knights,Florida Panthers,2024-10-19,1,3,4,-1,26,49,-23,1,2,0,50.0,56.7,0,Florida Panthers
Seattle Kraken,Calgary Flames,2024-10-19,1,2,1,1,23,22,1,6,3,16.7,66.7,55.7,1,Seattle Kraken
Utah Hockey Club,Boston Bruins,2024-10-19,2,2,1,1,32,22,10,4,3,0,100.0,53.1,1,Utah Hockey Club
Pittsburgh Penguins,Winnipeg Jets,2024-10-20,1,3,6,-3,42,37,5,1,2,100,100.0,54.8,0,Winnipeg Jets
Colorado Avalanche,San Jose Sharks,2024-10-20,1,4,1,3,22,26,-4,4,5,25,80.0,50.8,0,Colorado Avalanche
Anaheim Ducks,Los Angeles Kings,2024-10-20,1,1,4,-3,14,36,-22,3,2,0,100.0,37.7,1,Los Angeles Kings
Los Angeles Kings,Anaheim Ducks,2024-10-20,2,4,1,3,36,14,22,2,3,0,100.0,62.3,0,Los Angeles Kings
San Jose Sharks,Colorado Avalanche,2024-10-20,1,1,4,-3,26,22,4,5,4,20,75.0,49.2,1,Colorado Avalanche
Winnipeg Jets,Pittsburgh Penguins,2024-10-20,1,6,3,3,37,42,-5,2,1,0,0.0,45.2,1,Winnipeg Jets
Toronto Maple Leafs,Tampa Bay Lightning,2024-10-21,1,5,2,3,29,34,-5,4,6,25,83.3,37.0,1,Toronto Maple Leafs
Tampa Bay Lightning,Toronto Maple Leafs,2024-10-21,1,2,5,-3,34,29,5,6,4,16.7,75.0,63.0,0,Toronto Maple Leafs
New Jersey Devils,Tampa Bay Lightning,2024-10-22,2,5,8,-3,35,37,-2,3,2,66.7,0.0,50.7,1,Tampa Bay Lightning
New York Islanders,Detroit Red Wings,2024-10-22,2,0,1,-1,30,11,19,3,1,0,100.0,52.4,1,Detroit Red Wings
New York Rangers,Montreal Canadiens,2024-10-22,2,7,2,5,45,23,22,3,3,33.3,66.7,47.1,0,New York Rangers
Philadelphia Flyers,Washington Capitals,2024-10-22,2,1,4,-3,18,29,-11,3,5,0,100.0,47.1,1,Washington Capitals
Pittsburgh Penguins,Calgary Flames,2024-10-22,1,3,3,0,38,25,13,4,4,25,100.0,63.2,0,Calgary Flames
Boston Bruins,Nashville Predators,2024-10-22,2,0,4,-4,33,42,-9,4,6,0,83.3,43.3,0,Nashville Predators
Buffalo Sabres,Dallas Stars,2024-10-22,2,4,2,2,25,30,-5,1,3,0,100.0,38.8,1,Buffalo Sabres
Montréal Canadiens,New York Rangers,2024-10-22,2,2,7,-5,23,45,-22,3,3,33.3,66.7,52.9,0,New York Rangers
Ottawa Senators,Utah Hockey Club,2024-10-22,2,4,0,4,22,31,-9,1,2,100,100.0,40.7,0,Ottawa Senators
Toronto Maple Leafs,Columbus Blue Jackets,2024-10-22,0,2,6,-4,28,38,-10,3,4,0,100.0,45.7,0,Columbus Blue Jackets
Carolina Hurricanes,Edmonton Oilers,2024-10-22,2,3,2,1,33,35,-2,2,4,50,75.0,44.2,0,Carolina Hurricanes
Florida Panthers,Minnesota Wild,2024-10-22,2,1,5,-4,25,22,3,0,2,--,50.0,44.0,1,Minnesota Wild
Tampa Bay Lightning,New Jersey Devils,2024-10-22,0,8,5,3,37,35,2,2,3,100,33.3,49.3,0,Tampa Bay Lightning
Washington Capitals,Philadelphia Flyers,2024-10-22,2,4,1,3,29,18,11,5,3,0,100.0,52.9,0,Washington Capitals
Chicago Blackhawks,Vancouver Canucks,2024-10-22,2,3,6,-3,34,30,4,5,3,20,33.3,59.7,1,Vancouver Canucks
Detroit Red Wings,New York Islanders,2024-10-22,2,1,0,1,11,30,-19,1,3,0,100.0,47.6,0,Detroit Red Wings
Nashville Predators,Boston Bruins,2024-10-22,2,4,0,4,42,33,9,6,4,16.7,100.0,56.7,1,Nashville Predators
St. Louis Blues,Winnipeg Jets,2024-10-22,2,2,3,-1,29,24,5,2,2,0,50.0,42.3,1,Winnipeg Jets
Calgary Flames,Pittsburgh Penguins,2024-10-22,2,3,3,0,25,38,-13,4,4,0,75.0,36.8,1,Pittsburgh Penguins
Colorado Avalanche,Seattle Kraken,2024-10-22,1,3,2,1,28,27,1,3,1,33.3,0.0,37.5,0,Colorado Avalanche
Edmonton Oilers,Carolina Hurricanes,2024-10-22,2,2,3,-1,35,33,2,4,2,25.0,50,55.8,1,Carolina Hurricanes
Vancouver Canucks,Chicago Blackhawks,2024-10-22,2,6,3,3,30,34,-4,3,5,66.7,80,40.3,0,Vancouver Canucks
Anaheim Ducks,San Jose Sharks,2024-10-22,1,3,1,2,40,28,12,6,2,33.3,50,45.1,1,Anaheim Ducks
Dallas Stars,Buffalo Sabres,2024-10-22,2,2,4,-2,30,25,5,3,1,0.0,100,61.2,0,Buffalo Sabres
Los Angeles Kings,Vegas Golden Knights,2024-10-22,1,1,6,-5,35,30,5,4,2,0.0,0,36.0,0,Vegas Golden Knights
San Jose Sharks,Anaheim Ducks,2024-10-22,1,1,3,-2,28,40,-12,2,6,50.0,66.7,54.9,0,Anaheim Ducks
Columbus Blue Jackets,Toronto Maple Leafs,2024-10-22,2,6,2,4,38,28,10,4,3,0.0,100,54.3,1,Columbus Blue Jackets
Minnesota Wild,Florida Panthers,2024-10-22,2,5,1,4,22,25,-3,2,0,50.0,--,56.0,0,Minnesota Wild
Winnipeg Jets,St. Louis Blues,2024-10-22,1,3,2,1,24,29,-5,2,2,50.0,100,57.7,0,Winnipeg Jets
Vegas Golden Knights,Los Angeles Kings,2024-10-22,2,6,1,5,30,35,-5,2,4,100.0,100,64.0,1,Vegas Golden Knights
Seattle Kraken,Colorado Avalanche,2024-10-22,2,2,3,-1,27,28,-1,1,3,100.0,66.7,62.5,1,Colorado Avalanche
Utah Hockey Club,Ottawa Senators,2024-10-22,2,0,4,-4,31,22,9,2,1,0.0,0,59.3,1,Ottawa Senators
Philadelphia Flyers,Washington Capitals,2024-10-23,0,3,6,-3,29,25,4,4,3,50.0,100,61.8,0,Washington Capitals
Washington Capitals,Philadelphia Flyers,2024-10-23,0,6,3,3,25,29,-4,3,4,0.0,50,38.2,1,Washington Capitals
New Jersey Devils,Detroit Red Wings,2024-10-24,1,3,5,-2,40,20,20,5,4,60.0,50,50.0,0,Detroit Red Wings
New York Rangers,Florida Panthers,2024-10-24,1,1,3,-2,25,29,-4,4,2,0.0,100,60.8,1,Florida Panthers
Boston Bruins,Dallas Stars,2024-10-24,1,2,5,-3,27,32,-5,4,5,25.0,40,52.8,1,Dallas Stars
Toronto Maple Leafs,St. Louis Blues,2024-10-24,1,1,5,-4,41,27,14,4,2,0.0,50,68.3,1,St. Louis Blues
Carolina Hurricanes,Calgary Flames,2024-10-24,1,4,2,2,43,32,11,3,2,33.3,100,58.9,0,Carolina Hurricanes
Florida Panthers,New York Rangers,2024-10-24,1,3,1,2,29,25,4,2,4,0.0,100,39.2,0,Florida Panthers
Tampa Bay Lightning,Minnesota Wild,2024-10-24,1,2,4,-2,26,18,8,1,4,0.0,75,44.2,1,Minnesota Wild
Detroit Red Wings,New Jersey Devils,2024-10-24,1,5,3,2,20,40,-20,4,5,50.0,40,50.0,1,Detroit Red Wings
St. Louis Blues,Toronto Maple Leafs,2024-10-24,1,5,1,4,27,41,-14,2,4,50.0,100,31.7,0,St. Louis Blues
Calgary Flames,Carolina Hurricanes,2024-10-24,1,2,4,-2,32,43,-11,2,3,0.0,66.7,41.1,1,Carolina Hurricanes
Colorado Avalanche,Utah Hockey Club,2024-10-24,1,5,1,4,26,26,0,4,3,50.0,100,28.1,0,Colorado Avalanche
Dallas Stars,Boston Bruins,2024-10-24,1,5,2,3,32,27,5,5,4,60.0,75,47.2,0,Dallas Stars
Los Angeles Kings,San Jose Sharks,2024-10-24,1,3,2,1,30,26,4,2,6,0.0,66.7,46.6,1,Los Angeles Kings
San Jose Sharks,Los Angeles Kings,2024-10-24,1,2,3,-1,26,30,-4,6,2,33.3,100,53.5,0,Los Angeles Kings
Minnesota Wild,Tampa Bay Lightning,2024-10-24,1,4,2,2,18,26,-8,4,1,25.0,100,55.8,0,Minnesota Wild
Winnipeg Jets,Seattle Kraken,2024-10-24,1,4,3,1,36,32,4,1,2,0.0,100,53.3,0,Winnipeg Jets
Seattle Kraken,Winnipeg Jets,2024-10-24,1,3,4,-1,32,36,-4,2,1,0.0,100,46.7,1,Winnipeg Jets
Utah Hockey Club,Colorado Avalanche,2024-10-24,1,1,5,-4,26,26,0,3,4,0.0,50,71.9,1,Colorado Avalanche
New Jersey Devils,New York Islanders,2024-10-25,0,3,4,-1,36,30,6,2,4,0.0,75,37.5,1,New York Islanders
New York Islanders,New Jersey Devils,2024-10-25,2,4,3,1,30,36,-6,4,2,25.0,100,62.5,0,New York Islanders
Pittsburgh Penguins,Edmonton Oilers,2024-10-25,2,0,4,-4,27,50,-23,2,2,0.0,50,42.6,0,Edmonton Oilers
Ottawa Senators,Vegas Golden Knights,2024-10-25,2,4,6,-2,39,28,11,2,2,50.0,50,46.5,0,Vegas Golden Knights
Chicago Blackhawks,Nashville Predators,2024-10-25,2,2,3,-1,29,34,-5,5,5,0.0,80,41.9,1,Nashville Predators
Nashville Predators,Chicago Blackhawks,2024-10-25,2,3,2,1,34,29,5,5,5,20.0,100,58.1,0,Nashville Predators
Edmonton Oilers,Pittsburgh Penguins,2024-10-25,2,4,0,4,50,27,23,2,2,50.0,100,57.5,1,Edmonton Oilers
Vegas Golden Knights,Ottawa Senators,2024-10-25,2,6,4,2,28,39,-11,2,2,50.0,50,53.5,1,Vegas Golden Knights
New York Islanders,Florida Panthers,2024-10-26,0,3,6,-3,28,29,-1,3,2,0.0,50,58.2,1,Florida Panthers
New York Rangers,Anaheim Ducks,2024-10-26,1,2,1,1,32,33,-1,1,1,0.0,100,50.0,1,New York Rangers
Philadelphia Flyers,Minnesota Wild,2024-10-26,2,7,5,2,23,26,-3,2,4,50.0,75,50.9,1,Philadelphia Flyers
Pittsburgh Penguins,Vancouver Canucks,2024-10-26,0,3,4,-1,24,34,-10,2,3,0.0,100,42.9,0,Vancouver Canucks
Boston Bruins,Toronto Maple Leafs,2024-10-26,1,4,3,1,34,23,11,5,3,20.0,100,39.7,1,Boston Bruins
Buffalo Sabres,Detroit Red Wings,2024-10-26,3,5,3,2,39,25,14,4,2,25.0,100,32.9,1,Buffalo Sabres
Montréal Canadiens,St. Louis Blues,2024-10-26,3,5,2,3,26,31,-5,3,3,33.3,100,44.0,0,Montréal Canadiens
Toronto Maple Leafs,Boston Bruins,2024-10-26,1,3,4,-1,23,34,-11,3,5,0.0,80,60.3,0,Boston Bruins
Carolina Hurricanes,Seattle Kraken,2024-10-26,1,4,1,3,39,19,20,6,3,16.7,100,45.9,0,Carolina Hurricanes
Florida Panthers,New York Islanders,2024-10-26,1,6,3,3,29,28,1,2,3,50.0,100,41.8,0,Florida Panthers
Tampa Bay Lightning,Washington Capitals,2024-10-26,1,3,0,3,21,32,-11,3,2,0.0,100,41.7,1,Tampa Bay Lightning
Washington Capitals,Tampa Bay Lightning,2024-10-26,2,0,3,-3,32,21,11,2,3,0.0,100,58.3,0,Tampa Bay Lightning
Chicago Blackhawks,Dallas Stars,2024-10-26,0,2,4,-2,24,30,-6,3,3,0.0,66.7,51.9,0,Dallas Stars
Detroit Red Wings,Buffalo Sabres,2024-10-26,1,3,5,-2,25,39,-14,2,4,0.0,75,67.1,0,Buffalo Sabres
Nashville Predators,Columbus Blue Jackets,2024-10-26,0,4,3,1,33,28,5,2,2,0.0,100,50.9,1,Nashville Predators
St. Louis Blues,Montreal Canadiens,2024-10-26,1,2,5,-3,31,26,5,3,3,0.0,66.7,56.0,0,Montreal Canadiens
Calgary Flames,Winnipeg Jets,2024-10-26,1,3,5,-2,29,35,-6,4,4,0.0,50,53.4,1,Winnipeg Jets
Vancouver Canucks,Pittsburgh Penguins,2024-10-26,3,4,3,1,34,24,10,3,2,0.0,100,57.1,1,Vancouver Canucks
Anaheim Ducks,New York Rangers,2024-10-26,3,1,2,-1,33,32,1,1,1,0.0,100,50.0,0,New York Rangers
Dallas Stars,Chicago Blackhawks,2024-10-26,1,4,2,2,30,24,6,3,3,33.3,100,48.1,1,Dallas Stars
Los Angeles Kings,Utah Hockey Club,2024-10-26,1,3,2,1,23,26,-3,3,3,33.3,100,40.0,1,Los Angeles Kings
San Jose Sharks,Vegas Golden Knights,2024-10-26,1,3,7,-4,26,42,-16,2,4,0.0,75,49.1,0,Vegas Golden Knights
Columbus Blue Jackets,Nashville Predators,2024-10-26,3,3,4,-1,28,33,-5,2,2,0.0,100,49.1,0,Nashville Predators
Minnesota Wild,Philadelphia Flyers,2024-10-26,1,5,7,-2,26,23,3,4,2,25.0,50,49.1,0,Philadelphia Flyers
Winnipeg Jets,Calgary Flames,2024-10-26,1,5,3,2,35,29,6,4,4,50.0,100,46.6,0,Winnipeg Jets
Vegas Golden Knights,San Jose Sharks,2024-10-26,0,7,3,4,42,26,16,4,2,25.0,100,50.9,1,Vegas Golden Knights
Seattle Kraken,Carolina Hurricanes,2024-10-26,1,1,4,-3,19,39,-20,3,6,0.0,83.3,54.1,1,Carolina Hurricanes
Utah Hockey Club,Los Angeles Kings,2024-10-26,1,2,3,-1,26,23,3,3,3,0.0,66.7,60.0,0,Los Angeles Kings
New Jersey Devils,Anaheim Ducks,2024-10-27,1,6,2,4,34,26,8,1,2,100.0,100,61.9,1,New Jersey Devils
Philadelphia Flyers,Montreal Canadiens,2024-10-27,0,3,4,-1,26,24,2,3,2,0.0,50,62.1,1,Montreal Canadiens
Montréal Canadiens,Philadelphia Flyers,2024-10-27,0,4,3,1,24,26,-2,2,3,50.0,100,37.9,0,Montréal Canadiens
Ottawa Senators,Colorado Avalanche,2024-10-27,1,4,5,-1,30,32,-2,1,1,0.0,100,55.6,0,Colorado Avalanche
Detroit Red Wings,Edmonton Oilers,2024-10-27,0,2,3,-1,26,34,-8,1,2,0.0,100,60.3,1,Edmonton Oilers
Colorado Avalanche,Ottawa Senators,2024-10-27,2,5,4,1,32,30,2,1,1,0.0,100,44.4,1,Colorado Avalanche
Edmonton Oilers,Detroit Red Wings,2024-10-27,1,3,2,1,34,26,8,2,1,0.0,100,39.7,0,Edmonton Oilers
Anaheim Ducks,New Jersey Devils,2024-10-27,0,2,6,-4,26,34,-8,2,1,0.0,0,38.1,0,New Jersey Devils
Buffalo Sabres,Florida Panthers,2024-10-28,1,2,5,-3,28,31,-3,3,4,33.3,50,64.5,1,Florida Panthers
Toronto Maple Leafs,Winnipeg Jets,2024-10-28,1,6,4,2,36,23,13,2,4,0.0,50,66.7,0,Toronto Maple Leafs
Carolina Hurricanes,Vancouver Canucks,2024-10-28,1,4,3,1,32,27,5,3,3,0.0,100,48.2,0,Carolina Hurricanes
Florida Panthers,Buffalo Sabres,2024-10-28,1,5,2,3,31,28,3,4,3,50.0,66.7,35.5,0,Florida Panthers
Tampa Bay Lightning,Nashville Predators,2024-10-28,1,3,2,1,27,37,-10,3,4,0.0,75,50.0,1,Tampa Bay Lightning
Chicago Blackhawks,Colorado Avalanche,2024-10-28,1,5,2,3,26,26,0,3,4,33.3,75,42.9,0,Chicago Blackhawks
Nashville Predators,Tampa Bay Lightning,2024-10-28,1,2,3,-1,37,27,10,4,3,25.0,100,50.0,0,Tampa Bay Lightning
Calgary Flames,Vegas Golden Knights,2024-10-28,1,0,5,-5,16,38,-22,1,2,0.0,100,42.2,0,Vegas Golden Knights
Colorado Avalanche,Chicago Blackhawks,2024-10-28,0,2,5,-3,26,26,0,4,3,25.0,66.7,57.1,1,Chicago Blackhawks
Edmonton Oilers,Columbus Blue Jackets,2024-10-28,0,1,6,-5,32,25,7,6,4,16.7,75,61.8,0,Columbus Blue Jackets
Vancouver Canucks,Carolina Hurricanes,2024-10-28,1,3,4,-1,27,32,-5,3,3,0.0,100,51.9,1,Carolina Hurricanes
San Jose Sharks,Utah Hockey Club,2024-10-28,1,5,4,1,46,23,23,4,2,25.0,100,45.8,0,San Jose Sharks
Columbus Blue Jackets,Edmonton Oilers,2024-10-28,1,6,1,5,25,32,-7,4,6,25.0,83.3,38.2,1,Columbus Blue Jackets
Winnipeg Jets,Toronto Maple Leafs,2024-10-28,1,4,6,-2,23,36,-13,4,2,50.0,100,33.3,1,Toronto Maple Leafs
Vegas Golden Knights,Calgary Flames,2024-10-28,1,5,0,5,38,16,22,2,1,0.0,100,57.8,1,Vegas Golden Knights
Utah Hockey Club,San Jose Sharks,2024-10-28,1,4,5,-1,23,46,-23,2,4,0.0,75,54.2,1,San Jose Sharks
New York Islanders,Anaheim Ducks,2024-10-29,2,1,3,-2,41,22,19,4,3,25.0,33.3,67.2,1,Anaheim Ducks
New York Rangers,Washington Capitals,2024-10-29,2,3,5,-2,19,46,-27,3,4,33.3,100,38.2,0,Washington Capitals
Philadelphia Flyers,Boston Bruins,2024-10-29,1,2,0,2,19,25,-6,2,4,0.0,100,60.8,0,Philadelphia Flyers
Pittsburgh Penguins,Minnesota Wild,2024-10-29,2,3,5,-2,29,40,-11,2,5,50.0,100,58.3,1,Minnesota Wild
Boston Bruins,Philadelphia Flyers,2024-10-29,2,0,2,-2,25,19,6,4,2,0.0,100,39.2,1,Philadelphia Flyers
Montréal Canadiens,Seattle Kraken,2024-10-29,1,2,8,-6,30,23,7,4,6,0.0,50,45.3,0,Seattle Kraken
Ottawa Senators,St. Louis Blues,2024-10-29,1,8,1,7,35,27,8,3,4,66.7,75,58.6,1,Ottawa Senators
Washington Capitals,New York Rangers,2024-10-29,2,5,3,2,46,19,27,4,3,0.0,66.7,61.8,1,Washington Capitals
St. Louis Blues,Ottawa Senators,2024-10-29,2,1,8,-7,27,35,-8,4,3,25,33.3,41.4,0,Ottawa Senators
Anaheim Ducks,New York Islanders,2024-10-29,1,3,1,2,22,41,-19,3,4,66.7,75,32.8,0,Anaheim Ducks
Los Angeles Kings,San Jose Sharks,2024-10-29,2,2,4,-2,28,21,7,6,4,0,100,57.9,0,San Jose Sharks
San Jose Sharks,Los Angeles Kings,2024-10-29,0,4,2,2,21,28,-7,4,6,0,100,42.1,1,San Jose Sharks
Minnesota Wild,Pittsburgh Penguins,2024-10-29,2,5,3,2,40,29,11,5,2,0,50,41.7,0,Minnesota Wild
Seattle Kraken,Montreal Canadiens,2024-10-29,2,8,2,6,23,30,-7,6,4,50,100,54.7,0,Seattle Kraken
New Jersey Devils,Vancouver Canucks,2024-10-30,2,6,0,6,22,20,2,2,4,50,100,49.1,0,New Jersey Devils
New York Islanders,Columbus Blue Jackets,2024-10-30,0,0,2,-2,26,26,0,1,0,0,--,60.0,0,Columbus Blue Jackets
Tampa Bay Lightning,Colorado Avalanche,2024-10-30,1,5,2,3,21,35,-14,3,4,0,75,59.6,0,Tampa Bay Lightning
Detroit Red Wings,Winnipeg Jets,2024-10-30,2,2,6,-4,21,29,-8,3,2,66.7,50,38.9,1,Winnipeg Jets
Calgary Flames,Utah Hockey Club,2024-10-30,1,1,5,-4,31,28,3,3,4,0,50,42.4,0,Utah Hockey Club
Colorado Avalanche,Tampa Bay Lightning,2024-10-30,1,2,5,-3,35,21,14,4,3,25,100,40.4,1,Tampa Bay Lightning
Vancouver Canucks,New Jersey Devils,2024-10-30,1,0,6,-6,20,22,-2,4,2,0,50,50.9,1,New Jersey Devils
Los Angeles Kings,Vegas Golden Knights,2024-10-30,0,6,3,3,27,26,1,1,3,100,66.7,50.0,1,Los Angeles Kings
Columbus Blue Jackets,New York Islanders,2024-10-30,1,2,0,2,26,26,0,0,1,--,100,40.0,1,Columbus Blue Jackets
Winnipeg Jets,Detroit Red Wings,2024-10-30,1,6,2,4,29,21,8,2,3,50,33.3,61.1,0,Winnipeg Jets
Vegas Golden Knights,Los Angeles Kings,2024-10-30,1,3,6,-3,26,27,-1,3,1,33.3,0,50.0,0,Los Angeles Kings
Utah Hockey Club,Calgary Flames,2024-10-30,1,5,1,4,28,31,-3,4,3,50,100,57.6,1,Utah Hockey Club
Philadelphia Flyers,St. Louis Blues,2024-10-31,1,2,1,1,21,21,0,3,2,0,100,53.5,1,Philadelphia Flyers
Pittsburgh Penguins,Anaheim Ducks,2024-10-31,1,2,1,1,45,23,22,3,2,0,100,54.4,1,Pittsburgh Penguins
Boston Bruins,Carolina Hurricanes,2024-10-31,1,2,8,-6,15,37,-22,5,5,20,40,56.2,0,Carolina Hurricanes
Montréal Canadiens,Washington Capitals,2024-10-31,1,3,6,-3,15,34,-19,6,5,16.7,80,61.0,0,Washington Capitals
Toronto Maple Leafs,Seattle Kraken,2024-10-31,2,4,1,3,30,25,5,2,3,0,100,55.6,1,Toronto Maple Leafs
Carolina Hurricanes,Boston Bruins,2024-10-31,2,8,2,6,37,15,22,5,5,60,80,43.8,1,Carolina Hurricanes
Washington Capitals,Montreal Canadiens,2024-10-31,1,6,3,3,34,15,19,5,6,20,83.3,39.0,1,Washington Capitals
Chicago Blackhawks,San Jose Sharks,2024-10-31,2,2,3,-1,29,29,0,3,1,0,0,39.0,0,San Jose Sharks
Nashville Predators,Edmonton Oilers,2024-10-31,2,1,5,-4,27,29,-2,3,1,33.3,100,46.0,1,Edmonton Oilers
St. Louis Blues,Philadelphia Flyers,2024-10-31,1,1,2,-1,21,21,0,2,3,0,100,46.5,0,Philadelphia Flyers
Edmonton Oilers,Nashville Predators,2024-10-31,2,5,1,4,29,27,2,1,3,0,66.7,54.0,0,Edmonton Oilers
Anaheim Ducks,Pittsburgh Penguins,2024-10-31,1,1,2,-1,23,45,-22,2,3,0,100,45.6,0,Pittsburgh Penguins
San Jose Sharks,Chicago Blackhawks,2024-10-31,1,3,2,1,29,29,0,1,3,100,100,61.0,1,San Jose Sharks
Seattle Kraken,Toronto Maple Leafs,2024-10-31,1,1,4,-3,25,30,-5,3,2,0,100,44.4,0,Toronto Maple Leafs
New Jersey Devils,Calgary Flames,2024-11-01,1,0,3,-3,22,32,-10,3,4,0,100,48.5,0,Calgary Flames
New York Islanders,Buffalo Sabres,2024-11-01,1,4,3,1,36,35,1,4,4,25,75,54.4,0,New York Islanders
New York Rangers,Ottawa Senators,2024-11-01,2,2,1,1,18,41,-23,2,5,50,100,54.2,1,New York Rangers
Buffalo Sabres,New York Islanders,2024-11-01,3,3,4,-1,35,36,-1,4,4,25,75,45.6,1,New York Islanders
Ottawa Senators,New York Rangers,2024-11-01,2,1,2,-1,41,18,23,5,2,0,50,45.8,0,New York Rangers
Florida Panthers,Dallas Stars,2024-11-01,3,6,4,2,28,36,-8,2,3,50,100,53.0,0,Florida Panthers
Tampa Bay Lightning,Minnesota Wild,2024-11-01,1,3,5,-2,30,22,8,4,2,50,100,53.7,0,Minnesota Wild
Calgary Flames,New Jersey Devils,2024-11-01,1,3,0,3,32,22,10,4,3,0,100,51.5,1,Calgary Flames
Dallas Stars,Florida Panthers,2024-11-01,4,4,6,-2,36,28,8,3,2,0,50,47.0,1,Florida Panthers
Columbus Blue Jackets,Winnipeg Jets,2024-11-01,1,2,6,-4,22,44,-22,2,2,50,50,51.7,1,Winnipeg Jets
Minnesota Wild,Tampa Bay Lightning,2024-11-01,2,5,3,2,22,30,-8,2,4,0,50,46.3,1,Minnesota Wild
Winnipeg Jets,Columbus Blue Jackets,2024-11-01,1,6,2,4,44,22,22,2,2,50,50,48.3,0,Winnipeg Jets
Philadelphia Flyers,Boston Bruins,2024-11-02,1,0,3,-3,20,31,-11,3,2,0,100,46.7,1,Boston Bruins
Pittsburgh Penguins,Montreal Canadiens,2024-11-02,1,3,1,2,24,26,-2,2,2,50,100,57.1,1,Pittsburgh Penguins
Boston Bruins,Philadelphia Flyers,2024-11-02,1,3,0,3,31,20,11,2,3,0,100,53.3,0,Boston Bruins
Buffalo Sabres,Detroit Red Wings,2024-11-02,0,1,2,-1,32,23,9,2,4,0,50,39.7,0,Detroit Red Wings
Montréal Canadiens,Pittsburgh Penguins,2024-11-02,1,1,3,-2,26,24,2,2,2,0,50,42.9,0,Pittsburgh Penguins
Ottawa Senators,Seattle Kraken,2024-11-02,0,3,0,3,23,22,1,3,4,0,100,55.3,1,Ottawa Senators
Toronto Maple Leafs,St. Louis Blues,2024-11-02,1,2,4,-2,37,24,13,4,4,0,100,65.3,0,St. Louis Blues
Florida Panthers,Dallas Stars,2024-11-02,0,4,2,2,25,25,0,4,4,25,75,46.3,1,Florida Panthers
Washington Capitals,Columbus Blue Jackets,2024-11-02,1,7,2,5,22,36,-14,1,3,0,100,39.7,1,Washington Capitals
Chicago Blackhawks,Los Angeles Kings,2024-11-02,1,3,3,0,21,40,-19,2,3,0,66.7,34.5,0,Los Angeles Kings
Detroit Red Wings,Buffalo Sabres,2024-11-02,2,2,1,1,23,32,-9,4,2,50,100,60.3,1,Detroit Red Wings
Nashville Predators,Colorado Avalanche,2024-11-02,1,5,2,3,26,31,-5,2,4,100,75,50.8,1,Nashville Predators
St. Louis Blues,Toronto Maple Leafs,2024-11-02,1,4,2,2,24,37,-13,4,4,0,100,34.7,1,St. Louis Blues
Colorado Avalanche,Nashville Predators,2024-11-02,2,2,5,-3,31,26,5,4,2,25,0,49.2,0,Nashville Predators
Vancouver Canucks,San Jose Sharks,2024-11-02,2,3,2,1,28,23,5,2,2,0,100,48.7,0,Vancouver Canucks
Dallas Stars,Florida Panthers,2024-11-02,0,2,4,-2,25,25,0,4,4,25,75,53.7,0,Florida Panthers
Los Angeles Kings,Chicago Blackhawks,2024-11-02,2,3,3,0,40,21,19,3,2,33.3,100,65.5,1,Chicago Blackhawks
San Jose Sharks,Vancouver Canucks,2024-11-02,1,2,3,-1,23,28,-5,2,2,0,100,51.3,1,Vancouver Canucks
Columbus Blue Jackets,Washington Capitals,2024-11-02,0,2,7,-5,36,22,14,3,1,0,100,60.3,0,Washington Capitals
Vegas Golden Knights,Utah Hockey Club,2024-11-02,2,4,3,1,35,19,16,1,0,0,--,47.1,1,Vegas Golden Knights
Seattle Kraken,Ottawa Senators,2024-11-02,1,0,3,-3,22,23,-1,4,3,0,100,44.7,0,Ottawa Senators
Utah Hockey Club,Vegas Golden Knights,2024-11-02,2,3,4,-1,19,35,-16,0,1,--,100,52.9,0,Vegas Golden Knights
New York Islanders,New York Rangers,2024-11-03,1,2,5,-3,37,40,-3,5,3,0,66.7,57.4,0,New York Rangers
New York Rangers,New York Islanders,2024-11-03,1,5,2,3,40,37,3,3,5,33.3,100,42.6,1,New York Rangers
Boston Bruins,Seattle Kraken,2024-11-03,0,2,0,2,33,23,10,5,3,20,100,63.3,1,Boston Bruins
Toronto Maple Leafs,Minnesota Wild,2024-11-03,0,1,2,-1,28,33,-5,2,3,50,100,51.1,0,Minnesota Wild
Carolina Hurricanes,Washington Capitals,2024-11-03,2,4,2,2,45,21,24,3,4,0,75,50.0,1,Carolina Hurricanes
Tampa Bay Lightning,Winnipeg Jets,2024-11-03,1,4,7,-3,30,34,-4,2,3,50,66.7,54.2,0,Winnipeg Jets
Washington Capitals,Carolina Hurricanes,2024-11-03,0,2,4,-2,21,45,-24,4,3,25,100,50.0,0,Carolina Hurricanes
Chicago Blackhawks,Anaheim Ducks,2024-11-03,0,4,2,2,29,40,-11,2,5,100,80,49.1,0,Chicago Blackhawks
Calgary Flames,Edmonton Oilers,2024-11-03,1,2,4,-2,31,31,0,2,3,50,66.7,53.2,1,Edmonton Oilers
Edmonton Oilers,Calgary Flames,2024-11-03,2,4,2,2,31,31,0,3,2,33.3,50,46.8,0,Edmonton Oilers
Anaheim Ducks,Chicago Blackhawks,2024-11-03,2,2,4,-2,40,29,11,5,2,20,0,50.9,1,Chicago Blackhawks
Minnesota Wild,Toronto Maple Leafs,2024-11-03,1,2,1,1,33,28,5,3,2,0,50,48.9,1,Minnesota Wild
Winnipeg Jets,Tampa Bay Lightning,2024-11-03,1,7,4,3,34,30,4,3,2,33.3,50,45.8,1,Winnipeg Jets
Seattle Kraken,Boston Bruins,2024-11-03,0,0,2,-2,23,33,-10,3,5,0,80,36.7,0,Boston Bruins
New Jersey Devils,Edmonton Oilers,2024-11-04,2,3,0,3,16,31,-15,1,1,100,100,51.1,0,New Jersey Devils
Nashville Predators,Los Angeles Kings,2024-11-04,1,0,3,-3,16,27,-11,3,4,0,100,45.5,1,Los Angeles Kings
Edmonton Oilers,New Jersey Devils,2024-11-04,0,0,3,-3,31,16,15,1,1,0,0,48.9,1,New Jersey Devils
Los Angeles Kings,Nashville Predators,2024-11-04,1,3,0,3,27,16,11,4,3,0,100,54.6,0,Los Angeles Kings
New York Islanders,Pittsburgh Penguins,2024-11-05,1,3,3,0,26,35,-9,4,4,25,75,50.8,1,Pittsburgh Penguins
Philadelphia Flyers,Carolina Hurricanes,2024-11-05,2,4,6,-2,16,35,-19,3,2,33.3,100,58.9,0,Carolina Hurricanes
Pittsburgh Penguins,New York Islanders,2024-11-05,2,3,3,0,35,26,9,4,4,25,75,49.2,0,New York Islanders
Boston Bruins,Toronto Maple Leafs,2024-11-05,1,0,4,-4,29,27,2,6,7,0,57.1,45.2,0,Toronto Maple Leafs
Buffalo Sabres,Ottawa Senators,2024-11-05,2,5,1,4,34,38,-4,4,3,50,100,43.6,1,Buffalo Sabres
Montréal Canadiens,Calgary Flames,2024-11-05,2,2,3,-1,24,35,-11,3,1,33.3,100,57.4,0,Calgary Flames
Ottawa Senators,Buffalo Sabres,2024-11-05,2,1,5,-4,38,34,4,3,4,0,50,56.5,0,Buffalo Sabres
Toronto Maple Leafs,Boston Bruins,2024-11-05,1,4,0,4,27,29,-2,7,6,42.9,100,54.8,1,Toronto Maple Leafs
Carolina Hurricanes,Philadelphia Flyers,2024-11-05,1,6,4,2,35,16,19,2,3,0,66.7,41.1,1,Carolina Hurricanes
Tampa Bay Lightning,St. Louis Blues,2024-11-05,1,2,3,-1,23,23,0,3,1,0,100,52.4,0,St. Louis Blues
St. Louis Blues,Tampa Bay Lightning,2024-11-05,2,3,2,1,23,23,0,1,3,0,100,47.6,1,St. Louis Blues
Calgary Flames,Montreal Canadiens,2024-11-05,1,3,2,1,35,24,11,1,3,0,66.7,42.7,0,Calgary Flames
Colorado Avalanche,Seattle Kraken,2024-11-05,2,6,3,3,32,20,12,5,3,60,66.7,45.8,1,Colorado Avalanche
Vancouver Canucks,Anaheim Ducks,2024-11-05,2,5,1,4,37,22,15,5,4,20,75,54.0,0,Vancouver Canucks
Anaheim Ducks,Vancouver Canucks,2024-11-05,1,1,5,-4,22,37,-15,4,5,25,80,46.0,1,Vancouver Canucks
Los Angeles Kings,Minnesota Wild,2024-11-05,0,5,1,4,28,24,4,1,4,100,100,52.4,0,Los Angeles Kings
San Jose Sharks,Columbus Blue Jackets,2024-11-05,2,2,1,1,27,50,-23,4,3,0,100,48.2,1,San Jose Sharks
Columbus Blue Jackets,San Jose Sharks,2024-11-05,2,1,2,-1,50,27,23,3,4,0,100,51.8,0,San Jose Sharks
Minnesota Wild,Los Angeles Kings,2024-11-05,1,1,5,-4,24,28,-4,4,1,0,0,47.6,1,Los Angeles Kings
Winnipeg Jets,Utah Hockey Club,2024-11-05,1,3,0,3,28,21,7,2,4,50,100,54.4,1,Winnipeg Jets
Seattle Kraken,Colorado Avalanche,2024-11-05,1,3,6,-3,20,32,-12,3,5,33.3,40,54.2,0,Colorado Avalanche
Utah Hockey Club,Winnipeg Jets,2024-11-05,2,0,3,-3,21,28,-7,4,2,0,50,45.6,0,Winnipeg Jets
Washington Capitals,Nashville Predators,2024-11-06,2,3,2,1,36,35,1,6,2,0,100,47.6,1,Washington Capitals
Chicago Blackhawks,Detroit Red Wings,2024-11-06,2,1,4,-3,29,25,4,2,2,0,100,52.8,1,Detroit Red Wings
Detroit Red Wings,Chicago Blackhawks,2024-11-06,3,4,1,3,25,29,-4,2,2,0,100,47.2,0,Detroit Red Wings
Nashville Predators,Washington Capitals,2024-11-06,1,2,3,-1,35,36,-1,2,6,0,100,52.4,0,Washington Capitals
Edmonton Oilers,Vegas Golden Knights,2024-11-06,1,2,4,-2,29,35,-6,1,2,0,50,50.9,1,Vegas Golden Knights
Vegas Golden Knights,Edmonton Oilers,2024-11-06,3,4,2,2,35,29,6,2,1,50,100,49.1,0,Vegas Golden Knights
New Jersey Devils,Montreal Canadiens,2024-11-07,2,5,3,2,27,24,3,3,2,0,100,52.9,1,New Jersey Devils
New York Islanders,Ottawa Senators,2024-11-07,1,4,2,2,25,30,-5,2,3,0,66.7,50.9,0,New York Islanders
New York Rangers,Buffalo Sabres,2024-11-07,3,1,6,-5,26,22,4,4,4,0,75,48.2,1,Buffalo Sabres
Philadelphia Flyers,Tampa Bay Lightning,2024-11-07,1,1,1,0,31,23,8,2,2,0,100,51.2,0,Tampa Bay Lightning
Pittsburgh Penguins,Carolina Hurricanes,2024-11-07,1,1,5,-4,36,18,18,4,1,0,100,47.4,0,Carolina Hurricanes
Boston Bruins,Calgary Flames,2024-11-07,1,4,3,1,38,37,1,2,3,0,66.7,53.2,1,Boston Bruins
Buffalo Sabres,New York Rangers,2024-11-07,1,6,1,5,22,26,-4,4,4,25,100,51.9,0,Buffalo Sabres
Montréal Canadiens,New Jersey Devils,2024-11-07,1,3,5,-2,24,27,-3,2,3,0,100,47.1,0,New Jersey Devils
Ottawa Senators,New York Islanders,2024-11-07,1,2,4,-2,30,25,5,3,2,33.3,100,49.1,1,New York Islanders
Carolina Hurricanes,Pittsburgh Penguins,2024-11-07,1,5,1,4,18,36,-18,1,4,0,100,52.6,1,Carolina Hurricanes
Florida Panthers,Nashville Predators,2024-11-07,4,6,2,4,34,18,16,7,5,28.6,80,40.6,1,Florida Panthers
Tampa Bay Lightning,Philadelphia Flyers,2024-11-07,1,1,1,0,23,31,-8,2,2,0,100,48.8,1,Philadelphia Flyers
Chicago Blackhawks,Dallas Stars,2024-11-07,0,1,3,-2,26,40,-14,3,3,33.3,100,28.6,0,Dallas Stars
Nashville Predators,Florida Panthers,2024-11-07,0,2,6,-4,18,34,-16,5,7,20,71.4,59.4,0,Florida Panthers
St. Louis Blues,Utah Hockey Club,2024-11-07,1,2,4,-2,15,31,-16,3,2,0,100,40.3,1,Utah Hockey Club
Calgary Flames,Boston Bruins,2024-11-07,1,3,4,-1,37,38,-1,3,2,33.3,100,46.8,0,Boston Bruins
Colorado Avalanche,Winnipeg Jets,2024-11-07,1,0,1,-1,35,28,7,1,2,0,100,44.1,0,Winnipeg Jets
Vancouver Canucks,Los Angeles Kings,2024-11-07,1,4,2,2,23,28,-5,3,4,33.3,100,51.0,0,Vancouver Canucks
Dallas Stars,Chicago Blackhawks,2024-11-07,4,3,1,2,40,26,14,3,3,0,66.7,71.4,1,Dallas Stars
Los Angeles Kings,Vancouver Canucks,2024-11-07,1,2,4,-2,28,23,5,4,3,0,66.7,49.0,1,Vancouver Canucks
San Jose Sharks,Minnesota Wild,2024-11-07,1,2,5,-3,26,31,-5,3,3,0,66.7,62.5,1,Minnesota Wild
Minnesota Wild,San Jose Sharks,2024-11-07,1,5,2,3,31,26,5,3,3,33.3,100,37.5,0,Minnesota Wild
Winnipeg Jets,Colorado Avalanche,2024-11-07,1,1,0,1,28,35,-7,2,1,0,100,55.9,1,Winnipeg Jets
Utah Hockey Club,St. Louis Blues,2024-11-07,1,4,2,2,31,15,16,2,3,0,100,59.7,0,Utah Hockey Club
Pittsburgh Penguins,Washington Capitals,2024-11-08,0,4,2,2,32,34,-2,2,3,0,100,49.2,0,Pittsburgh Penguins
Toronto Maple Leafs,Detroit Red Wings,2024-11-08,2,3,1,2,20,22,-2,2,3,100,66.7,43.1,1,Toronto Maple Leafs
Washington Capitals,Pittsburgh Penguins,2024-11-08,1,2,4,-2,34,32,2,3,2,0,100,50.9,1,Pittsburgh Penguins
Detroit Red Wings,Toronto Maple Leafs,2024-11-08,1,1,3,-2,22,20,2,3,2,33.3,0,56.9,0,Toronto Maple Leafs
Anaheim Ducks,Minnesota Wild,2024-11-08,2,2,5,-3,35,31,4,6,2,0,50,41.7,1,Minnesota Wild
Minnesota Wild,Anaheim Ducks,2024-11-08,0,5,2,3,31,35,-4,2,6,50,100,58.3,0,Minnesota Wild
Vegas Golden Knights,Seattle Kraken,2024-11-08,1,3,4,-1,24,32,-8,4,1,25,100,48.2,0,Seattle Kraken
Seattle Kraken,Vegas Golden Knights,2024-11-08,2,4,3,1,32,24,8,1,4,0,75,51.9,1,Seattle Kraken
New Jersey Devils,New York Islanders,2024-11-09,1,4,3,1,33,22,11,2,0,50,--,44.4,0,New Jersey Devils
New York Islanders,New Jersey Devils,2024-11-09,1,3,4,-1,22,33,-11,0,2,--,50,55.6,1,New Jersey Devils
New York Rangers,Detroit Red Wings,2024-11-09,1,4,0,4,24,37,-13,2,2,50,100,44.8,0,New York Rangers
Philadelphia Flyers,Florida Panthers,2024-11-09,1,3,3,0,37,31,6,2,2,0,100,44.3,0,Florida Panthers
Boston Bruins,Ottawa Senators,2024-11-09,1,2,3,-1,16,34,-18,2,3,0,66.7,47.1,1,Ottawa Senators
Buffalo Sabres,Calgary Flames,2024-11-09,1,2,2,0,19,26,-7,2,3,50,100,60.0,1,Calgary Flames
Montréal Canadiens,Toronto Maple Leafs,2024-11-09,1,1,4,-3,21,27,-6,2,4,50,50,43.6,0,Toronto Maple Leafs
Ottawa Senators,Boston Bruins,2024-11-09,1,3,2,1,34,16,18,3,2,33.3,100,52.9,0,Ottawa Senators
Toronto Maple Leafs,Montreal Canadiens,2024-11-09,0,4,1,3,27,21,6,4,2,50,50,56.5,1,Toronto Maple Leafs
Carolina Hurricanes,Colorado Avalanche,2024-11-09,1,4,6,-2,31,29,2,4,5,25,80,59.7,0,Colorado Avalanche
Florida Panthers,Philadelphia Flyers,2024-11-09,1,3,3,0,31,37,-6,2,2,0,100,55.7,1,Philadelphia Flyers
Washington Capitals,St. Louis Blues,2024-11-09,0,8,1,7,27,25,2,2,3,100,100,46.2,0,Washington Capitals
Detroit Red Wings,New York Rangers,2024-11-09,0,0,4,-4,37,24,13,2,2,0,50,55.2,1,New York Rangers
Nashville Predators,Utah Hockey Club,2024-11-09,1,4,0,4,21,27,-6,4,2,50,100,56.3,1,Nashville Predators
St. Louis Blues,Washington Capitals,2024-11-09,1,1,8,-7,25,27,-2,3,2,0,0,53.9,1,Washington Capitals
Calgary Flames,Buffalo Sabres,2024-11-09,1,2,2,0,26,19,7,3,2,0,50,40.0,0,Buffalo Sabres
Colorado Avalanche,Carolina Hurricanes,2024-11-09,1,6,4,2,29,31,-2,5,4,20,75,40.3,1,Colorado Avalanche
Edmonton Oilers,Vancouver Canucks,2024-11-09,2,7,3,4,31,20,11,3,2,33.3,50,46.7,0,Edmonton Oilers
Vancouver Canucks,Edmonton Oilers,2024-11-09,1,3,7,-4,20,31,-11,2,3,50,66.7,53.3,1,Edmonton Oilers
Dallas Stars,Winnipeg Jets,2024-11-09,1,1,4,-3,33,25,8,4,5,0,60,53.9,0,Winnipeg Jets
Los Angeles Kings,Columbus Blue Jackets,2024-11-09,1,5,2,3,23,26,-3,4,3,25,66.7,56.9,1,Los Angeles Kings
Columbus Blue Jackets,Los Angeles Kings,2024-11-09,3,2,5,-3,26,23,3,3,4,33.3,75,43.1,0,Los Angeles Kings
Winnipeg Jets,Dallas Stars,2024-11-09,1,4,1,3,25,33,-8,5,4,40,100,46.2,1,Winnipeg Jets
Utah Hockey Club,Nashville Predators,2024-11-09,1,0,4,-4,27,21,6,2,4,0,50,43.8,0,Nashville Predators
New Jersey Devils,San Jose Sharks,2024-11-10,0,0,1,-1,44,27,17,2,3,0,100,58.8,1,San Jose Sharks
Chicago Blackhawks,Minnesota Wild,2024-11-10,2,2,1,1,22,33,-11,3,3,0,100,51.9,1,Chicago Blackhawks
Anaheim Ducks,Columbus Blue Jackets,2024-11-10,1,4,2,2,30,40,-10,2,2,0,50,43.3,1,Anaheim Ducks
San Jose Sharks,New Jersey Devils,2024-11-10,2,1,0,1,27,44,-17,3,2,0,100,41.2,0,San Jose Sharks
Columbus Blue Jackets,Anaheim Ducks,2024-11-10,0,2,4,-2,40,30,10,2,2,50,100,56.7,0,Anaheim Ducks
Minnesota Wild,Chicago Blackhawks,2024-11-10,1,1,2,-1,33,22,11,3,3,0,100,48.2,0,Chicago Blackhawks
Philadelphia Flyers,San Jose Sharks,2024-11-11,1,3,3,0,43,31,12,3,3,33.3,100,50.0,1,San Jose Sharks
Pittsburgh Penguins,Dallas Stars,2024-11-11,2,1,7,-6,21,40,-19,1,4,0,50,49.0,1,Dallas Stars
Buffalo Sabres,Montreal Canadiens,2024-11-11,1,5,7,-2,18,23,-5,4,6,25,66.7,60.6,1,Montreal Canadiens
Montréal Canadiens,Buffalo Sabres,2024-11-11,1,7,5,2,23,18,5,6,4,33.3,75,39.4,0,Montréal Canadiens
Carolina Hurricanes,Vegas Golden Knights,2024-11-11,1,5,2,3,34,32,2,4,3,0,66.7,59.7,0,Carolina Hurricanes
Nashville Predators,Colorado Avalanche,2024-11-11,1,2,3,-1,30,32,-2,2,2,0,100,55.4,0,Colorado Avalanche
Calgary Flames,Los Angeles Kings,2024-11-11,1,3,1,2,28,29,-1,2,1,0,100,54.4,1,Calgary Flames
Colorado Avalanche,Nashville Predators,2024-11-11,1,3,2,1,32,30,2,2,2,0,100,44.6,1,Colorado Avalanche
Dallas Stars,Pittsburgh Penguins,2024-11-11,1,7,1,6,40,21,19,4,1,50,100,51.0,0,Dallas Stars
Los Angeles Kings,Calgary Flames,2024-11-11,1,1,3,-2,29,28,1,1,2,0,100,45.7,0,Calgary Flames
San Jose Sharks,Philadelphia Flyers,2024-11-11,0,3,3,0,31,43,-12,3,3,0,66.7,50.0,0,Philadelphia Flyers
Vegas Golden Knights,Carolina Hurricanes,2024-11-11,2,2,5,-3,32,34,-2,3,4,33.3,100,40.3,1,Carolina Hurricanes
New Jersey Devils,Florida Panthers,2024-11-12,1,4,1,3,24,35,-11,1,3,0,66.7,39.7,0,New Jersey Devils
New York Islanders,Edmonton Oilers,2024-11-12,2,3,4,-1,22,42,-20,2,2,0,50,46.7,0,Edmonton Oilers
New York Rangers,Winnipeg Jets,2024-11-12,2,3,6,-3,36,33,3,4,2,25,50,64.7,1,Winnipeg Jets
Boston Bruins,St. Louis Blues,2024-11-12,2,3,2,1,30,22,8,4,3,0,33.3,54.2,0,Boston Bruins
Ottawa Senators,Toronto Maple Leafs,2024-11-12,2,3,0,3,41,27,14,3,4,0,100,46.3,0,Ottawa Senators
Toronto Maple Leafs,Ottawa Senators,2024-11-12,2,0,3,-3,27,41,-14,4,3,0,100,53.7,1,Ottawa Senators
Florida Panthers,New Jersey Devils,2024-11-12,2,1,4,-3,35,24,11,3,1,33.3,100,60.3,1,New Jersey Devils
St. Louis Blues,Boston Bruins,2024-11-12,2,2,3,-1,22,30,-8,3,4,66.7,100,45.8,1,Boston Bruins
Calgary Flames,Vancouver Canucks,2024-11-12,0,1,3,-2,29,32,-3,2,3,0,66.7,41.0,0,Vancouver Canucks
Edmonton Oilers,New York Islanders,2024-11-12,2,4,3,1,42,22,20,2,2,50,100,53.3,1,Edmonton Oilers
Vancouver Canucks,Calgary Flames,2024-11-12,2,3,1,2,32,29,3,3,2,33.3,100,59.0,1,Vancouver Canucks
Columbus Blue Jackets,Seattle Kraken,2024-11-12,1,2,5,-3,40,33,7,1,3,0,66.7,54.6,0,Seattle Kraken
Winnipeg Jets,New York Rangers,2024-11-12,2,6,3,3,33,36,-3,2,4,50,75,35.3,0,Winnipeg Jets
Seattle Kraken,Columbus Blue Jackets,2024-11-12,3,5,2,3,33,40,-7,3,1,33.3,100,45.5,1,Seattle Kraken
Pittsburgh Penguins,Detroit Red Wings,2024-11-13,1,2,3,-1,33,31,2,2,2,0,50,45.5,1,Detroit Red Wings
Toronto Maple Leafs,Washington Capitals,2024-11-13,0,4,3,1,34,27,7,2,1,50,100,46.3,0,Toronto Maple Leafs
Carolina Hurricanes,Utah Hockey Club,2024-11-13,1,1,4,-3,50,21,29,6,1,16.7,100,58.9,0,Utah Hockey Club
Washington Capitals,Toronto Maple Leafs,2024-11-13,3,3,4,-1,27,34,-7,1,2,0,50,53.7,1,Toronto Maple Leafs
Detroit Red Wings,Pittsburgh Penguins,2024-11-13,3,3,2,1,31,33,-2,2,2,50,100,54.6,0,Detroit Red Wings
Colorado Avalanche,Los Angeles Kings,2024-11-13,1,4,2,2,26,15,11,3,1,0,100,32.8,1,Colorado Avalanche
Anaheim Ducks,Vegas Golden Knights,2024-11-13,2,2,3,-1,24,39,-15,3,3,0,66.7,41.2,1,Vegas Golden Knights
Los Angeles Kings,Colorado Avalanche,2024-11-13,1,2,4,-2,15,26,-11,1,3,0,100,67.2,0,Colorado Avalanche
Vegas Golden Knights,Anaheim Ducks,2024-11-13,1,3,2,1,39,24,15,3,3,33.3,100,58.8,0,Vegas Golden Knights
Utah Hockey Club,Carolina Hurricanes,2024-11-13,3,4,1,3,21,50,-29,1,6,0,83.3,41.1,1,Utah Hockey Club
New Jersey Devils,Florida Panthers,2024-11-14,1,6,2,4,29,27,2,5,5,60,100,61.1,0,New Jersey Devils
New York Islanders,Vancouver Canucks,2024-11-14,1,5,2,3,32,26,6,5,1,20,100,59.3,0,New York Islanders
New York Rangers,San Jose Sharks,2024-11-14,1,3,2,1,35,27,8,1,3,0,66.7,50.0,1,New York Rangers
Philadelphia Flyers,Ottawa Senators,2024-11-14,2,5,4,1,19,37,-18,2,6,0,66.7,38.6,0,Philadelphia Flyers
Boston Bruins,Dallas Stars,2024-11-14,1,2,7,-5,25,38,-13,2,2,0,100,57.1,0,Dallas Stars
Buffalo Sabres,St. Louis Blues,2024-11-14,2,4,3,1,33,27,6,3,1,33.3,100,36.1,1,Buffalo Sabres
Montréal Canadiens,Minnesota Wild,2024-11-14,2,0,3,-3,19,28,-9,3,3,0,66.7,54.0,0,Minnesota Wild
Ottawa Senators,Philadelphia Flyers,2024-11-14,1,4,5,-1,37,19,18,6,2,33.3,100,61.4,1,Philadelphia Flyers
Florida Panthers,New Jersey Devils,2024-11-14,1,2,6,-4,27,29,-2,5,5,0,40,38.9,1,New Jersey Devils
Tampa Bay Lightning,Winnipeg Jets,2024-11-14,4,4,1,3,29,24,5,3,5,33.3,100,56.9,1,Tampa Bay Lightning
Chicago Blackhawks,Seattle Kraken,2024-11-14,3,1,3,-2,19,26,-7,1,3,0,66.7,48.2,0,Seattle Kraken
Nashville Predators,Edmonton Oilers,2024-11-14,2,2,3,-1,22,34,-12,2,4,0,100,52.6,0,Edmonton Oilers
St. Louis Blues,Buffalo Sabres,2024-11-14,1,3,4,-1,27,33,-6,1,3,0,66.7,63.9,0,Buffalo Sabres
Edmonton Oilers,Nashville Predators,2024-11-14,1,3,2,1,34,22,12,4,2,0,100,47.4,1,Edmonton Oilers
Vancouver Canucks,New York Islanders,2024-11-14,1,2,5,-3,26,32,-6,1,5,0,80,40.7,1,New York Islanders
Dallas Stars,Boston Bruins,2024-11-14,2,7,2,5,38,25,13,2,2,0,100,42.9,1,Dallas Stars
San Jose Sharks,New York Rangers,2024-11-14,2,2,3,-1,27,35,-8,3,1,33.3,100,50.0,0,New York Rangers
Minnesota Wild,Montreal Canadiens,2024-11-14,3,3,0,3,28,19,9,3,3,33.3,100,46.0,1,Minnesota Wild
Winnipeg Jets,Tampa Bay Lightning,2024-11-14,1,1,4,-3,24,29,-5,5,3,0,66.7,43.1,0,Tampa Bay Lightning
Seattle Kraken,Chicago Blackhawks,2024-11-14,1,3,1,2,26,19,7,3,1,33.3,100,51.8,1,Seattle Kraken
Pittsburgh Penguins,Columbus Blue Jackets,2024-11-15,1,2,6,-4,23,39,-16,4,5,25,80,47.5,0,Columbus Blue Jackets
Washington Capitals,Colorado Avalanche,2024-11-15,1,5,2,3,20,19,1,2,1,50,100,50.8,0,Washington Capitals
Detroit Red Wings,Anaheim Ducks,2024-11-15,1,4,6,-2,25,29,-4,4,4,75,50,58.6,0,Anaheim Ducks
Nashville Predators,Calgary Flames,2024-11-15,0,0,2,-2,29,33,-4,2,4,0,100,50.6,0,Calgary Flames
Calgary Flames,Nashville Predators,2024-11-15,2,2,0,2,33,29,4,4,2,0,100,49.4,1,Calgary Flames
Colorado Avalanche,Washington Capitals,2024-11-15,1,2,5,-3,19,20,-1,1,2,0,50,49.2,1,Washington Capitals
Anaheim Ducks,Detroit Red Wings,2024-11-15,1,6,4,2,29,25,4,4,4,50,25,41.4,1,Anaheim Ducks
Columbus Blue Jackets,Pittsburgh Penguins,2024-11-15,2,6,2,4,39,23,16,5,4,20,75,52.5,1,Columbus Blue Jackets
Vegas Golden Knights,Utah Hockey Club,2024-11-15,1,4,2,2,29,32,-3,3,4,66.7,75,39.1,0,Vegas Golden Knights
Utah Hockey Club,Vegas Golden Knights,2024-11-15,1,2,4,-2,32,29,3,4,3,25,33.3,60.9,1,Vegas Golden Knights
New Jersey Devils,Tampa Bay Lightning,2024-11-16,1,0,4,-4,29,26,3,4,3,0,66.7,50.0,0,Tampa Bay Lightning
New York Islanders,Seattle Kraken,2024-11-16,1,2,3,-1,24,27,-3,1,4,0,100,57.9,0,Seattle Kraken
Philadelphia Flyers,Buffalo Sabres,2024-11-16,1,5,2,3,32,25,7,5,4,20,75,50.7,1,Philadelphia Flyers
Pittsburgh Penguins,San Jose Sharks,2024-11-16,0,3,3,0,36,29,7,1,4,0,75,56.5,1,San Jose Sharks
Boston Bruins,St. Louis Blues,2024-11-16,1,2,3,-1,18,31,-13,1,2,0,100,55.9,1,St. Louis Blues
Buffalo Sabres,Philadelphia Flyers,2024-11-16,1,2,5,-3,25,32,-7,4,5,25,80,49.4,0,Philadelphia Flyers
Montréal Canadiens,Columbus Blue Jackets,2024-11-16,1,5,1,4,30,26,4,4,4,25,100,50.0,0,Montréal Canadiens
Ottawa Senators,Carolina Hurricanes,2024-11-16,1,0,4,-4,24,28,-4,4,5,0,60,51.8,0,Carolina Hurricanes
Toronto Maple Leafs,Edmonton Oilers,2024-11-16,2,4,3,1,22,30,-8,4,2,0,50,44.2,1,Toronto Maple Leafs
Carolina Hurricanes,Ottawa Senators,2024-11-16,2,4,0,4,28,24,4,5,4,40,100,48.2,1,Carolina Hurricanes
Florida Panthers,Winnipeg Jets,2024-11-16,1,5,0,5,31,27,4,3,2,0,100,39.7,1,Florida Panthers
Tampa Bay Lightning,New Jersey Devils,2024-11-16,1,4,0,4,26,29,-3,3,4,33.3,100,50.0,1,Tampa Bay Lightning
Chicago Blackhawks,Vancouver Canucks,2024-11-16,1,1,4,-3,29,33,-4,1,3,0,66.7,37.3,0,Vancouver Canucks
Detroit Red Wings,Los Angeles Kings,2024-11-16,0,1,4,-3,18,41,-23,0,1,--,100,44.1,0,Los Angeles Kings
St. Louis Blues,Boston Bruins,2024-11-16,1,3,2,1,31,18,13,2,1,0,100,44.1,0,St. Louis Blues
Edmonton Oilers,Toronto Maple Leafs,2024-11-16,1,3,4,-1,30,22,8,2,4,50,100,55.8,0,Toronto Maple Leafs
Vancouver Canucks,Chicago Blackhawks,2024-11-16,1,4,1,3,33,29,4,3,1,33.3,100,62.8,1,Vancouver Canucks
Dallas Stars,Minnesota Wild,2024-11-16,1,2,1,1,40,23,17,1,2,0,100,57.1,0,Dallas Stars
Los Angeles Kings,Detroit Red Wings,2024-11-16,2,4,1,3,41,18,23,1,0,0,--,55.9,1,Los Angeles Kings
San Jose Sharks,Pittsburgh Penguins,2024-11-16,1,3,3,0,29,36,-7,4,1,25,100,43.5,0,Pittsburgh Penguins
Columbus Blue Jackets,Montreal Canadiens,2024-11-16,0,1,5,-4,26,30,-4,4,4,0,75,50.0,0,Montreal Canadiens
Minnesota Wild,Dallas Stars,2024-11-16,1,1,2,-1,23,40,-17,2,1,0,100,42.9,1,Dallas Stars
Winnipeg Jets,Florida Panthers,2024-11-16,1,0,5,-5,27,31,-4,2,3,0,100,60.3,0,Florida Panthers
Seattle Kraken,New York Islanders,2024-11-16,1,3,2,1,27,24,3,4,1,0,100,42.1,1,Seattle Kraken
New York Rangers,Seattle Kraken,2024-11-17,2,2,0,2,23,24,-1,0,1,--,100,55.1,0,New York Rangers
Carolina Hurricanes,St. Louis Blues,2024-11-17,0,4,1,3,24,30,-6,3,1,33.3,100,63.5,1,Carolina Hurricanes
Washington Capitals,Vegas Golden Knights,2024-11-17,1,5,2,3,25,42,-17,1,1,100,100,47.9,0,Washington Capitals
Nashville Predators,Vancouver Canucks,2024-11-17,1,5,3,2,22,27,-5,2,2,100,50,47.1,0,Nashville Predators
St. Louis Blues,Carolina Hurricanes,2024-11-17,0,1,4,-3,30,24,6,1,3,0,66.7,36.5,0,Carolina Hurricanes
Vancouver Canucks,Nashville Predators,2024-11-17,0,3,5,-2,27,22,5,2,2,50,0,52.9,1,Nashville Predators
Vegas Golden Knights,Washington Capitals,2024-11-17,1,2,5,-3,42,25,17,1,1,0,0,52.1,1,Washington Capitals
Seattle Kraken,New York Rangers,2024-11-17,0,0,2,-2,24,23,1,1,0,0,--,44.9,1,New York Rangers
Philadelphia Flyers,Colorado Avalanche,2024-11-18,1,2,3,-1,26,29,-3,3,4,0,75,58.3,1,Colorado Avalanche
Boston Bruins,Columbus Blue Jackets,2024-11-18,1,1,5,-4,29,28,1,6,2,16.7,100,49.2,1,Columbus Blue Jackets
Montréal Canadiens,Edmonton Oilers,2024-11-18,1,3,0,3,25,30,-5,2,3,0,100,43.6,0,Montréal Canadiens
Washington Capitals,Utah Hockey Club,2024-11-18,0,6,2,4,24,26,-2,3,7,33.3,100,47.4,0,Washington Capitals
Detroit Red Wings,San Jose Sharks,2024-11-18,1,4,5,-1,20,34,-14,3,4,66.7,75,45.2,0,San Jose Sharks
Colorado Avalanche,Philadelphia Flyers,2024-11-18,2,3,2,1,29,26,3,4,3,25,100,41.7,0,Colorado Avalanche
Edmonton Oilers,Montreal Canadiens,2024-11-18,1,0,3,-3,30,25,5,3,2,0,100,56.4,0,Montreal Canadiens
Anaheim Ducks,Dallas Stars,2024-11-18,2,4,2,2,27,36,-9,2,2,50,100,33.8,0,Anaheim Ducks
Dallas Stars,Anaheim Ducks,2024-11-18,1,2,4,-2,36,27,9,2,2,0,50,66.2,1,Anaheim Ducks
San Jose Sharks,Detroit Red Wings,2024-11-18,1,5,4,1,34,20,14,4,3,25,33.3,54.8,1,San Jose Sharks
Columbus Blue Jackets,Boston Bruins,2024-11-18,1,5,1,4,28,29,-1,2,6,0,83.3,50.9,0,Columbus Blue Jackets
Utah Hockey Club,Washington Capitals,2024-11-18,2,2,6,-4,26,24,2,7,3,0,66.7,52.6,1,Washington Capitals
New York Islanders,Calgary Flames,2024-11-19,2,1,1,0,29,31,-2,3,1,0,0,62.7,0,Calgary Flames
New York Rangers,Vancouver Canucks,2024-11-19,1,4,3,1,33,24,9,2,3,0,100,67.2,0,New York Rangers
Pittsburgh Penguins,Tampa Bay Lightning,2024-11-19,2,2,3,-1,19,35,-16,2,3,50,100,40.8,1,Tampa Bay Lightning
Ottawa Senators,Edmonton Oilers,2024-11-19,2,2,5,-3,29,31,-2,2,3,0,66.7,51.7,1,Edmonton Oilers
Florida Panthers,Winnipeg Jets,2024-11-19,2,3,6,-3,23,27,-4,4,4,50,75,57.4,0,Winnipeg Jets
Tampa Bay Lightning,Pittsburgh Penguins,2024-11-19,2,3,2,1,35,19,16,3,2,0,50,59.2,0,Tampa Bay Lightning
Chicago Blackhawks,Anaheim Ducks,2024-11-19,2,2,3,-1,20,24,-4,1,2,0,100,52.7,1,Anaheim Ducks
St. Louis Blues,Minnesota Wild,2024-11-19,1,2,4,-2,24,28,-4,2,2,50,100,53.5,1,Minnesota Wild
Calgary Flames,New York Islanders,2024-11-19,3,1,1,0,31,29,2,1,3,100,100,37.3,1,New York Islanders
Edmonton Oilers,Ottawa Senators,2024-11-19,0,5,2,3,31,29,2,3,2,33.3,100,48.3,0,Edmonton Oilers
Vancouver Canucks,New York Rangers,2024-11-19,1,3,4,-1,24,33,-9,3,2,0,100,32.8,1,New York Rangers
Anaheim Ducks,Chicago Blackhawks,2024-11-19,0,3,2,1,24,20,4,2,1,0,100,47.3,0,Anaheim Ducks
Minnesota Wild,St. Louis Blues,2024-11-19,2,4,2,2,28,24,4,2,2,0,50,46.6,0,Minnesota Wild
Winnipeg Jets,Florida Panthers,2024-11-19,2,6,3,3,27,23,4,4,4,25,50,42.6,1,Winnipeg Jets
Philadelphia Flyers,Carolina Hurricanes,2024-11-20,1,1,4,-3,19,37,-18,3,1,0,100,44.2,1,Carolina Hurricanes
Buffalo Sabres,Los Angeles Kings,2024-11-20,3,1,0,1,19,23,-4,3,5,33.3,100,40.4,0,Buffalo Sabres
Toronto Maple Leafs,Vegas Golden Knights,2024-11-20,3,3,0,3,26,31,-5,2,3,50,100,50.0,1,Toronto Maple Leafs
Carolina Hurricanes,Philadelphia Flyers,2024-11-20,2,4,1,3,37,19,18,1,3,0,100,55.8,0,Carolina Hurricanes
Nashville Predators,Seattle Kraken,2024-11-20,2,0,3,-3,24,37,-13,3,4,0,100,55.0,0,Seattle Kraken
Dallas Stars,San Jose Sharks,2024-11-20,1,5,2,3,31,23,8,4,3,0,100,54.7,1,Dallas Stars
Los Angeles Kings,Buffalo Sabres,2024-11-20,3,0,1,-1,23,19,4,5,3,0,66.7,59.7,1,Buffalo Sabres
San Jose Sharks,Dallas Stars,2024-11-20,1,2,5,-3,23,31,-8,3,4,0,100,45.3,0,Dallas Stars
Vegas Golden Knights,Toronto Maple Leafs,2024-11-20,2,0,3,-3,31,26,5,3,2,0,50,50.0,0,Toronto Maple Leafs
Seattle Kraken,Nashville Predators,2024-11-20,2,3,0,3,37,24,13,4,3,0,100,45.0,1,Seattle Kraken
New Jersey Devils,Carolina Hurricanes,2024-11-21,4,4,2,2,21,22,-1,3,2,66.7,50,48.0,1,New Jersey Devils
New York Islanders,Detroit Red Wings,2024-11-21,1,1,2,-1,23,31,-8,1,3,0,100,53.1,0,Detroit Red Wings
New York Rangers,Calgary Flames,2024-11-21,1,2,3,-1,29,49,-20,1,5,0,80,58.3,0,Calgary Flames
Boston Bruins,Utah Hockey Club,2024-11-21,2,1,0,1,31,22,9,7,4,14.3,100,53.5,1,Boston Bruins
Ottawa Senators,Vegas Golden Knights,2024-11-21,1,2,3,-1,40,32,8,3,2,33.3,100,56.5,1,Vegas Golden Knights
Carolina Hurricanes,New Jersey Devils,2024-11-21,0,2,4,-2,22,21,1,2,3,50,33.3,52.0,0,New Jersey Devils
Florida Panthers,Chicago Blackhawks,2024-11-21,1,1,3,-2,33,20,13,2,1,0,0,56.9,0,Chicago Blackhawks
Tampa Bay Lightning,Columbus Blue Jackets,2024-11-21,1,6,7,-1,30,43,-13,2,1,100,0,57.1,0,Columbus Blue Jackets
Washington Capitals,Colorado Avalanche,2024-11-21,2,1,2,-1,29,27,2,2,3,0,66.7,65.5,1,Colorado Avalanche
Chicago Blackhawks,Florida Panthers,2024-11-21,1,3,1,2,20,33,-13,1,2,100,100,43.1,1,Chicago Blackhawks
Detroit Red Wings,New York Islanders,2024-11-21,2,2,1,1,31,23,8,3,1,0,100,46.9,1,Detroit Red Wings
St. Louis Blues,San Jose Sharks,2024-11-21,1,2,2,0,31,24,7,1,2,0,50,50.9,1,San Jose Sharks
Calgary Flames,New York Rangers,2024-11-21,1,3,2,1,49,29,20,5,1,20,100,41.7,1,Calgary Flames
Colorado Avalanche,Washington Capitals,2024-11-21,2,2,1,1,27,29,-2,3,2,33.3,100,34.5,0,Colorado Avalanche
Edmonton Oilers,Minnesota Wild,2024-11-21,1,3,5,-2,31,26,5,2,1,0,100,57.1,1,Minnesota Wild
San Jose Sharks,St. Louis Blues,2024-11-21,0,2,2,0,24,31,-7,2,1,50,100,49.1,0,St. Louis Blues
Columbus Blue Jackets,Tampa Bay Lightning,2024-11-21,2,7,6,1,43,30,13,1,2,100,0,42.9,1,Columbus Blue Jackets
Minnesota Wild,Edmonton Oilers,2024-11-21,1,5,3,2,26,31,-5,1,2,0,100,42.9,0,Minnesota Wild
Vegas Golden Knights,Ottawa Senators,2024-11-21,0,3,2,1,32,40,-8,2,3,0,66.7,43.6,0,Vegas Golden Knights
Utah Hockey Club,Boston Bruins,2024-11-21,2,0,1,-1,22,31,-9,4,7,0,85.7,46.6,0,Boston Bruins
Pittsburgh Penguins,Winnipeg Jets,2024-11-22,2,1,4,-3,18,30,-12,3,3,33.3,66.7,49.2,1,Winnipeg Jets
Buffalo Sabres,Anaheim Ducks,2024-11-22,1,3,2,1,32,24,8,2,2,0,100,66.0,0,Buffalo Sabres
Anaheim Ducks,Buffalo Sabres,2024-11-22,2,2,3,-1,24,32,-8,2,2,0,100,34.0,1,Buffalo Sabres
Winnipeg Jets,Pittsburgh Penguins,2024-11-22,2,4,1,3,30,18,12,3,3,33.3,66.7,50.8,0,Winnipeg Jets
New Jersey Devils,Washington Capitals,2024-11-23,1,3,2,1,33,25,8,5,2,40,50,54.7,0,New Jersey Devils
New York Islanders,St. Louis Blues,2024-11-23,1,3,1,2,31,25,6,2,1,50,0,64.2,1,New York Islanders
New York Rangers,Edmonton Oilers,2024-11-23,1,2,6,-4,34,40,-6,3,3,0,100,44.0,0,Edmonton Oilers
Philadelphia Flyers,Chicago Blackhawks,2024-11-23,2,3,2,1,37,21,16,3,1,33.3,100,63.2,1,Philadelphia Flyers
Pittsburgh Penguins,Utah Hockey Club,2024-11-23,0,1,6,-5,28,30,-2,4,4,25,25,52.5,1,Utah Hockey Club
Boston Bruins,Detroit Red Wings,2024-11-23,1,2,1,1,29,20,9,2,4,50,100,55.0,0,Boston Bruins
Buffalo Sabres,San Jose Sharks,2024-11-23,0,4,2,2,31,33,-2,2,5,0,100,66.2,0,Buffalo Sabres
Montréal Canadiens,Vegas Golden Knights,2024-11-23,4,2,6,-4,17,28,-11,2,2,50,100,49.0,0,Vegas Golden Knights
Ottawa Senators,Vancouver Canucks,2024-11-23,1,3,4,-1,29,21,8,3,6,66.7,83.3,65.5,1,Vancouver Canucks
Carolina Hurricanes,Columbus Blue Jackets,2024-11-23,1,4,4,0,36,32,4,4,5,25,80,60.9,0,Columbus Blue Jackets
Florida Panthers,Colorado Avalanche,2024-11-23,1,4,7,-3,31,25,6,4,1,25,100,60.6,1,Colorado Avalanche
Tampa Bay Lightning,Dallas Stars,2024-11-23,1,2,4,-2,29,28,1,3,3,0,66.7,56.1,1,Dallas Stars
Washington Capitals,New Jersey Devils,2024-11-23,1,2,3,-1,25,33,-8,2,5,50,60,45.3,1,New Jersey Devils
Chicago Blackhawks,Philadelphia Flyers,2024-11-23,1,2,3,-1,21,37,-16,1,3,0,66.7,36.8,0,Philadelphia Flyers
Detroit Red Wings,Boston Bruins,2024-11-23,1,1,2,-1,20,29,-9,4,2,0,50,45.0,1,Boston Bruins
Nashville Predators,Winnipeg Jets,2024-11-23,2,4,1,3,36,24,12,3,3,33.3,100,52.0,1,Nashville Predators
St. Louis Blues,New York Islanders,2024-11-23,1,1,3,-2,25,31,-6,1,2,100,50,35.9,0,New York Islanders
Calgary Flames,Minnesota Wild,2024-11-23,1,3,3,0,31,23,8,2,3,100,66.7,35.4,1,Minnesota Wild
Colorado Avalanche,Florida Panthers,2024-11-23,1,7,4,3,25,31,-6,1,4,0,75,39.4,0,Colorado Avalanche
Edmonton Oilers,New York Rangers,2024-11-23,1,6,2,4,40,34,6,3,3,0,100,56.0,1,Edmonton Oilers
Vancouver Canucks,Ottawa Senators,2024-11-23,3,4,3,1,21,29,-8,6,3,16.7,33.3,34.5,0,Vancouver Canucks
Dallas Stars,Tampa Bay Lightning,2024-11-23,2,4,2,2,28,29,-1,3,3,33.3,100,43.9,0,Dallas Stars
Los Angeles Kings,Seattle Kraken,2024-11-23,2,2,1,1,21,20,1,1,3,100,100,53.3,1,Los Angeles Kings
San Jose Sharks,Buffalo Sabres,2024-11-23,1,2,4,-2,33,31,2,5,2,0,100,33.8,1,Buffalo Sabres
Columbus Blue Jackets,Carolina Hurricanes,2024-11-23,1,4,4,0,32,36,-4,5,4,20,75,39.1,1,Carolina Hurricanes
Minnesota Wild,Calgary Flames,2024-11-23,1,3,3,0,23,31,-8,3,2,33.3,0,64.6,0,Calgary Flames
Winnipeg Jets,Nashville Predators,2024-11-23,0,1,4,-3,24,36,-12,3,3,0,66.7,48.0,0,Nashville Predators
Vegas Golden Knights,Montreal Canadiens,2024-11-23,1,6,2,4,28,17,11,2,2,0,50,51.0,0,Vegas Golden Knights
Seattle Kraken,Los Angeles Kings,2024-11-23,2,1,2,-1,20,21,-1,3,1,0,0,46.7,0,Los Angeles Kings
Utah Hockey Club,Pittsburgh Penguins,2024-11-23,1,6,1,5,30,28,2,4,4,75,75,47.5,0,Utah Hockey Club
Toronto Maple Leafs,Utah Hockey Club,2024-11-24,3,3,2,1,35,26,9,6,2,16.7,50,54.1,1,Toronto Maple Leafs
Utah Hockey Club,Toronto Maple Leafs,2024-11-24,0,2,3,-1,26,35,-9,2,6,50,83.3,45.9,0,Toronto Maple Leafs
New Jersey Devils,Nashville Predators,2024-11-25,1,5,2,3,46,22,24,2,5,50,100,61.1,1,New Jersey Devils
New York Islanders,Detroit Red Wings,2024-11-25,1,2,4,-2,29,21,8,3,3,0,100,67.5,1,Detroit Red Wings
New York Rangers,St. Louis Blues,2024-11-25,1,2,5,-3,29,44,-15,3,3,0,100,56.1,1,St. Louis Blues
Philadelphia Flyers,Vegas Golden Knights,2024-11-25,1,4,4,0,36,30,6,3,1,0,0,49.2,1,Vegas Golden Knights
Ottawa Senators,Calgary Flames,2024-11-25,1,4,3,1,30,27,3,9,2,22.2,50,56.5,1,Ottawa Senators
Carolina Hurricanes,Dallas Stars,2024-11-25,1,6,4,2,34,19,15,2,3,100,100,59.7,1,Carolina Hurricanes
Florida Panthers,Washington Capitals,2024-11-25,1,1,4,-3,21,31,-10,4,4,0,75,42.1,1,Washington Capitals
Tampa Bay Lightning,Colorado Avalanche,2024-11-25,1,8,2,6,33,25,8,2,3,100,100,62.7,1,Tampa Bay Lightning
Washington Capitals,Florida Panthers,2024-11-25,1,4,1,3,31,21,10,4,4,25,100,57.9,0,Washington Capitals
Detroit Red Wings,New York Islanders,2024-11-25,1,4,2,2,21,29,-8,3,3,0,100,32.5,0,Detroit Red Wings
Nashville Predators,New Jersey Devils,2024-11-25,1,2,5,-3,22,46,-24,5,2,0,50,38.9,0,New Jersey Devils
St. Louis Blues,New York Rangers,2024-11-25,1,5,2,3,44,29,15,3,3,0,100,43.9,0,St. Louis Blues
Calgary Flames,Ottawa Senators,2024-11-25,1,3,4,-1,27,30,-3,2,9,50,77.8,43.5,0,Ottawa Senators
Colorado Avalanche,Tampa Bay Lightning,2024-11-25,1,2,8,-6,25,33,-8,3,2,0,0,37.3,0,Tampa Bay Lightning
Anaheim Ducks,Seattle Kraken,2024-11-25,2,2,3,-1,23,28,-5,1,3,0,100,40.4,1,Seattle Kraken
Dallas Stars,Carolina Hurricanes,2024-11-25,1,4,6,-2,19,34,-15,3,2,0,0,40.3,0,Carolina Hurricanes
Los Angeles Kings,San Jose Sharks,2024-11-25,1,2,7,-5,24,21,3,2,6,0,66.7,55.0,0,San Jose Sharks
San Jose Sharks,Los Angeles Kings,2024-11-25,1,7,2,5,21,24,-3,6,2,33.3,100,45.0,1,San Jose Sharks
Minnesota Wild,Winnipeg Jets,2024-11-25,1,1,4,-3,44,32,12,2,3,0,66.7,54.7,1,Winnipeg Jets
Winnipeg Jets,Minnesota Wild,2024-11-25,1,4,1,3,32,44,-12,3,2,33.3,100,45.3,0,Winnipeg Jets
Vegas Golden Knights,Philadelphia Flyers,2024-11-25,1,4,4,0,30,36,-6,1,3,100,100,50.8,0,Philadelphia Flyers
Seattle Kraken,Anaheim Ducks,2024-11-25,1,3,2,1,28,23,5,3,1,0,100,59.6,0,Seattle Kraken
Boston Bruins,Vancouver Canucks,2024-11-26,2,0,2,-2,33,15,18,3,2,0,50,59.0,1,Vancouver Canucks
Montréal Canadiens,Utah Hockey Club,2024-11-26,2,2,3,-1,13,29,-16,3,4,0,100,57.8,0,Utah Hockey Club
Vancouver Canucks,Boston Bruins,2024-11-26,2,2,0,2,15,33,-18,2,3,50,100,41.0,0,Vancouver Canucks
Utah Hockey Club,Montreal Canadiens,2024-11-26,1,3,2,1,29,13,16,4,3,0,100,42.2,0,Utah Hockey Club
New Jersey Devils,St. Louis Blues,2024-11-27,1,0,3,-3,32,20,12,3,3,0,100,44.0,1,St. Louis Blues
New York Islanders,Boston Bruins,2024-11-27,1,3,6,-3,24,21,3,1,0,0,--,50.9,1,Boston Bruins
New York Rangers,Carolina Hurricanes,2024-11-27,1,3,4,-1,22,31,-9,2,4,0,50,58.0,0,Carolina Hurricanes
Philadelphia Flyers,Nashville Predators,2024-11-27,1,3,2,1,23,27,-4,1,1,0,100,40.4,0,Philadelphia Flyers
Pittsburgh Penguins,Vancouver Canucks,2024-11-27,3,5,4,1,23,29,-6,4,1,25,100,64.9,1,Pittsburgh Penguins
Boston Bruins,New York Islanders,2024-11-27,0,6,3,3,21,24,-3,0,1,--,100,49.1,0,Boston Bruins
Buffalo Sabres,Minnesota Wild,2024-11-27,3,0,1,-1,39,30,9,2,0,0,--,53.3,1,Minnesota Wild
Montréal Canadiens,Columbus Blue Jackets,2024-11-27,0,4,3,1,23,24,-1,2,3,50,100,52.5,0,Montréal Canadiens
Ottawa Senators,San Jose Sharks,2024-11-27,1,4,3,1,11,39,-28,2,2,50,50,55.1,0,Ottawa Senators
Toronto Maple Leafs,Florida Panthers,2024-11-27,2,1,5,-4,24,24,0,3,5,33.3,60,60.0,0,Florida Panthers
Carolina Hurricanes,New York Rangers,2024-11-27,1,4,3,1,31,22,9,4,2,50,100,42.0,1,Carolina Hurricanes
Florida Panthers,Toronto Maple Leafs,2024-11-27,1,5,1,4,24,24,0,5,3,40,66.7,40.0,1,Florida Panthers
Tampa Bay Lightning,Washington Capitals,2024-11-27,1,4,5,-1,28,32,-4,3,3,33.3,66.7,36.2,1,Washington Capitals
Washington Capitals,Tampa Bay Lightning,2024-11-27,1,5,4,1,32,28,4,3,3,33.3,66.7,63.8,0,Washington Capitals
Chicago Blackhawks,Dallas Stars,2024-11-27,3,6,2,4,26,27,-1,2,4,50,75,36.5,1,Chicago Blackhawks
Detroit Red Wings,Calgary Flames,2024-11-27,1,2,1,1,27,25,2,4,4,50,75,58.1,1,Detroit Red Wings
Nashville Predators,Philadelphia Flyers,2024-11-27,1,2,3,-1,27,23,4,1,1,0,100,59.6,1,Philadelphia Flyers
St. Louis Blues,New Jersey Devils,2024-11-27,1,3,0,3,20,32,-12,3,3,0,100,56.0,0,St. Louis Blues
Calgary Flames,Detroit Red Wings,2024-11-27,1,1,2,-1,25,27,-2,4,4,25,50,41.9,0,Detroit Red Wings
Colorado Avalanche,Vegas Golden Knights,2024-11-27,1,1,1,0,34,19,15,2,1,0,100,52.0,1,Vegas Golden Knights
Vancouver Canucks,Pittsburgh Penguins,2024-11-27,0,4,5,-1,29,23,6,1,4,0,75,35.1,0,Pittsburgh Penguins
Anaheim Ducks,Seattle Kraken,2024-11-27,1,5,2,3,33,44,-11,2,5,50,100,38.0,0,Anaheim Ducks
Dallas Stars,Chicago Blackhawks,2024-11-27,1,2,6,-4,27,26,1,4,2,25,50,63.5,0,Chicago Blackhawks
Los Angeles Kings,Winnipeg Jets,2024-11-27,1,4,1,3,33,14,19,2,3,50,66.7,52.6,1,Los Angeles Kings
San Jose Sharks,Ottawa Senators,2024-11-27,1,3,4,-1,39,11,28,2,2,50,50,44.9,1,Ottawa Senators
Columbus Blue Jackets,Montreal Canadiens,2024-11-27,3,3,4,-1,24,23,1,3,2,0,50,47.5,1,Montreal Canadiens
Minnesota Wild,Buffalo Sabres,2024-11-27,1,1,0,1,30,39,-9,0,2,--,100,46.7,0,Minnesota Wild
Winnipeg Jets,Los Angeles Kings,2024-11-27,1,1,4,-3,14,33,-19,3,2,33.3,50,47.4,0,Los Angeles Kings
Vegas Golden Knights,Colorado Avalanche,2024-11-27,1,1,1,0,19,34,-15,1,2,0,100,48.0,0,Colorado Avalanche
Seattle Kraken,Anaheim Ducks,2024-11-27,1,2,5,-3,44,33,11,5,2,0,50,62.0,1,Anaheim Ducks
New Jersey Devils,Detroit Red Wings,2024-11-29,1,5,4,1,29,28,1,4,4,75,75,46.8,0,New Jersey Devils
New York Islanders,Washington Capitals,2024-11-29,1,4,5,-1,24,26,-2,3,4,0,50,57.6,0,Washington Capitals
New York Rangers,Philadelphia Flyers,2024-11-29,1,1,3,-2,23,35,-12,0,1,--,100,48.2,0,Philadelphia Flyers
Philadelphia Flyers,New York Rangers,2024-11-29,1,3,1,2,35,23,12,1,0,0,--,51.9,1,Philadelphia Flyers
Pittsburgh Penguins,Boston Bruins,2024-11-29,1,2,1,1,36,31,5,2,3,0,100,51.8,0,Pittsburgh Penguins
Boston Bruins,Pittsburgh Penguins,2024-11-29,1,1,2,-1,31,36,-5,3,2,0,100,48.2,1,Pittsburgh Penguins
Buffalo Sabres,Vancouver Canucks,2024-11-29,1,3,4,-1,34,22,12,5,4,0,75,51.8,1,Vancouver Canucks
Carolina Hurricanes,Florida Panthers,2024-11-29,1,3,6,-3,31,30,1,5,2,20,100,52.3,1,Florida Panthers
Florida Panthers,Carolina Hurricanes,2024-11-29,1,6,3,3,30,31,-1,2,5,0,80,47.7,0,Florida Panthers
Tampa Bay Lightning,Nashville Predators,2024-11-29,1,3,2,1,28,31,-3,4,2,25,100,49.2,0,Tampa Bay Lightning
Washington Capitals,New York Islanders,2024-11-29,1,5,4,1,26,24,2,4,3,50,100,42.4,1,Washington Capitals
Chicago Blackhawks,Minnesota Wild,2024-11-29,1,2,3,-1,23,29,-6,3,2,33.3,100,35.7,0,Minnesota Wild
Detroit Red Wings,New Jersey Devils,2024-11-29,1,4,5,-1,28,29,-1,4,4,25,25,53.2,1,New Jersey Devils
Nashville Predators,Tampa Bay Lightning,2024-11-29,1,2,3,-1,31,28,3,2,4,0,75,50.8,1,Tampa Bay Lightning
Calgary Flames,Columbus Blue Jackets,2024-11-29,1,2,5,-3,29,34,-5,2,1,50,0,50.0,0,Columbus Blue Jackets
Colorado Avalanche,Dallas Stars,2024-11-29,1,3,5,-2,32,24,8,5,4,20,50,42.5,0,Dallas Stars
Edmonton Oilers,Utah Hockey Club,2024-11-29,4,4,3,1,32,31,1,3,1,66.7,100,47.2,0,Edmonton Oilers
Vancouver Canucks,Buffalo Sabres,2024-11-29,1,4,3,1,22,34,-12,4,5,25,100,48.2,0,Vancouver Canucks
Anaheim Ducks,Los Angeles Kings,2024-11-29,1,1,2,-1,31,18,13,3,2,0,100,47.2,1,Los Angeles Kings
Dallas Stars,Colorado Avalanche,2024-11-29,1,5,3,2,24,32,-8,4,5,50,80,57.5,1,Dallas Stars
Los Angeles Kings,Anaheim Ducks,2024-11-29,1,2,1,1,18,31,-13,2,3,0,100,52.8,0,Los Angeles Kings
San Jose Sharks,Seattle Kraken,2024-11-29,1,8,5,3,27,31,-4,1,6,0,66.7,55.2,1,San Jose Sharks
Columbus Blue Jackets,Calgary Flames,2024-11-29,1,5,2,3,34,29,5,1,2,100,50,50.0,1,Columbus Blue Jackets
Minnesota Wild,Chicago Blackhawks,2024-11-29,1,3,2,1,29,23,6,2,3,0,66.7,64.3,1,Minnesota Wild
Winnipeg Jets,Vegas Golden Knights,2024-11-29,1,3,4,-1,25,30,-5,3,2,0,100,31.3,0,Vegas Golden Knights
Vegas Golden Knights,Winnipeg Jets,2024-11-29,1,4,3,1,30,25,5,2,3,0,100,68.8,1,Vegas Golden Knights
Seattle Kraken,San Jose Sharks,2024-11-29,1,5,8,-3,31,27,4,6,1,33.3,100,44.8,0,San Jose Sharks
Utah Hockey Club,Edmonton Oilers,2024-11-29,2,3,4,-1,31,32,-1,1,3,0,33.3,52.8,1,Edmonton Oilers
New Jersey Devils,Washington Capitals,2024-11-30,0,5,6,-1,27,32,-5,3,5,66.7,40,48.5,1,Washington Capitals
New York Islanders,Buffalo Sabres,2024-11-30,0,3,0,3,20,29,-9,3,2,33.3,100,57.1,1,New York Islanders
New York Rangers,Montreal Canadiens,2024-11-30,0,4,3,1,28,28,0,6,3,50,100,56.1,1,New York Rangers
Philadelphia Flyers,St. Louis Blues,2024-11-30,0,3,2,1,31,27,4,2,3,0,66.7,59.6,0,Philadelphia Flyers
Pittsburgh Penguins,Calgary Flames,2024-11-30,0,6,2,4,43,32,11,5,3,60,100,53.9,1,Pittsburgh Penguins
Buffalo Sabres,New York Islanders,2024-11-30,0,0,3,-3,29,20,9,2,3,0,66.7,42.9,0,New York Islanders
Montréal Canadiens,New York Rangers,2024-11-30,2,3,4,-1,28,28,0,3,6,0,50,43.9,0,New York Rangers
Ottawa Senators,Los Angeles Kings,2024-11-30,2,2,5,-3,22,27,-5,1,3,0,66.7,42.6,0,Los Angeles Kings
Toronto Maple Leafs,Tampa Bay Lightning,2024-11-30,2,5,3,2,29,41,-12,1,3,0,66.7,48.6,0,Toronto Maple Leafs
Carolina Hurricanes,Florida Panthers,2024-11-30,0,0,6,-6,20,35,-15,2,6,0,50,49.2,0,Florida Panthers
Florida Panthers,Carolina Hurricanes,2024-11-30,0,6,0,6,35,20,15,6,2,50,100,50.8,1,Florida Panthers
Tampa Bay Lightning,Toronto Maple Leafs,2024-11-30,0,3,5,-2,41,29,12,3,1,33.3,100,51.4,1,Toronto Maple Leafs
Washington Capitals,New Jersey Devils,2024-11-30,0,6,5,1,32,27,5,5,3,60,33.3,51.5,0,Washington Capitals
Nashville Predators,Minnesota Wild,2024-11-30,0,2,3,-1,27,28,-1,3,3,33.3,66.7,52.3,0,Minnesota Wild
St. Louis Blues,Philadelphia Flyers,2024-11-30,2,2,3,-1,27,31,-4,3,2,33.3,100,40.4,1,Philadelphia Flyers
Calgary Flames,Pittsburgh Penguins,2024-11-30,0,2,6,-4,32,43,-11,3,5,0,40,46.2,0,Pittsburgh Penguins
Colorado Avalanche,Edmonton Oilers,2024-11-30,0,1,4,-3,28,32,-4,5,2,20,100,30.2,1,Edmonton Oilers
Edmonton Oilers,Colorado Avalanche,2024-11-30,0,4,1,3,32,28,4,2,5,0,80,69.8,0,Edmonton Oilers
Los Angeles Kings,Ottawa Senators,2024-11-30,0,5,2,3,27,22,5,3,1,33.3,100,57.4,1,Los Angeles Kings
San Jose Sharks,Seattle Kraken,2024-11-30,0,4,2,2,23,38,-15,1,2,0,100,50.9,0,San Jose Sharks
Minnesota Wild,Nashville Predators,2024-11-30,0,3,2,1,28,27,1,3,3,33.3,66.7,47.7,1,Minnesota Wild
Vegas Golden Knights,Utah Hockey Club,2024-11-30,0,0,6,-6,29,28,1,4,3,0,66.7,62.8,1,Utah Hockey Club
Seattle Kraken,San Jose Sharks,2024-11-30,0,2,4,-2,38,23,15,2,1,0,100,49.1,1,San Jose Sharks
Utah Hockey Club,Vegas Golden Knights,2024-11-30,0,6,0,6,28,29,-1,3,4,33.3,100,37.3,0,Utah Hockey Club
Boston Bruins,Montreal Canadiens,2024-12-01,1,6,3,3,30,28,2,2,2,0,100,54.1,1,Boston Bruins
Montréal Canadiens,Boston Bruins,2024-12-01,0,3,6,-3,28,30,-2,2,2,0,100,45.9,0,Boston Bruins
Ottawa Senators,Anaheim Ducks,2024-12-01,0,3,3,0,31,34,-3,4,3,25,66.7,51.6,0,Anaheim Ducks
Chicago Blackhawks,Columbus Blue Jackets,2024-12-01,1,3,6,-3,31,36,-5,6,2,50,100,44.6,1,Columbus Blue Jackets
Detroit Red Wings,Vancouver Canucks,2024-12-01,1,4,5,-1,31,32,-1,4,4,25,50,50.0,1,Vancouver Canucks
Vancouver Canucks,Detroit Red Wings,2024-12-01,1,5,4,1,32,31,1,4,4,50,75,50.0,0,Vancouver Canucks
Anaheim Ducks,Ottawa Senators,2024-12-01,1,3,3,0,34,31,3,3,4,33.3,75,48.4,1,Ottawa Senators
Dallas Stars,Winnipeg Jets,2024-12-01,1,3,1,2,31,27,4,5,2,0,100,44.1,1,Dallas Stars
Columbus Blue Jackets,Chicago Blackhawks,2024-12-01,1,6,3,3,36,31,5,2,6,0,50,55.4,0,Columbus Blue Jackets
Winnipeg Jets,Dallas Stars,2024-12-01,1,1,3,-2,27,31,-4,2,5,0,100,55.9,0,Dallas Stars
New Jersey Devils,New York Rangers,2024-12-02,1,5,1,4,28,39,-11,4,4,50,75,41.0,0,New Jersey Devils
New York Rangers,New Jersey Devils,2024-12-02,1,1,5,-4,39,28,11,4,4,25,50,59.0,1,New Jersey Devils
Toronto Maple Leafs,Chicago Blackhawks,2024-12-02,1,4,1,3,22,28,-6,2,4,0,100,64.3,1,Toronto Maple Leafs
Chicago Blackhawks,Toronto Maple Leafs,2024-12-02,0,1,4,-3,28,22,6,4,2,0,100,35.7,0,Toronto Maple Leafs
Dallas Stars,Utah Hockey Club,2024-12-02,0,2,1,1,21,37,-16,3,2,33.3,100,42.9,0,Dallas Stars
Utah Hockey Club,Dallas Stars,2024-12-02,1,1,2,-1,37,21,16,2,3,0,66.7,57.1,1,Dallas Stars
New York Islanders,Montreal Canadiens,2024-12-03,2,1,2,-1,31,27,4,3,2,0,50,44.2,0,Montreal Canadiens
Pittsburgh Penguins,Florida Panthers,2024-12-03,2,5,4,1,16,41,-25,1,1,0,0,48.6,1,Pittsburgh Penguins
Boston Bruins,Detroit Red Wings,2024-12-03,1,3,2,1,35,25,10,3,3,33.3,100,45.5,1,Boston Bruins
Buffalo Sabres,Colorado Avalanche,2024-12-03,2,4,5,-1,30,41,-11,3,1,0,100,49.1,1,Colorado Avalanche
Montréal Canadiens,New York Islanders,2024-12-03,1,2,1,1,27,31,-4,2,3,50,100,55.8,0,Montréal Canadiens
Carolina Hurricanes,Seattle Kraken,2024-12-03,2,2,4,-2,19,28,-9,1,2,100,100,51.8,1,Seattle Kraken
Florida Panthers,Pittsburgh Penguins,2024-12-03,2,4,5,-1,41,16,25,1,1,100,100,51.4,0,Pittsburgh Penguins
Washington Capitals,San Jose Sharks,2024-12-03,2,1,2,-1,28,31,-3,3,4,0,75,50.9,1,San Jose Sharks
Detroit Red Wings,Boston Bruins,2024-12-03,1,2,3,-1,25,35,-10,3,3,0,66.7,54.6,0,Boston Bruins
St. Louis Blues,Winnipeg Jets,2024-12-03,2,4,1,3,32,23,9,3,2,0,100,62.1,0,St. Louis Blues
Calgary Flames,Columbus Blue Jackets,2024-12-03,2,3,0,3,22,16,6,4,1,50,100,59.6,1,Calgary Flames
Colorado Avalanche,Buffalo Sabres,2024-12-03,2,5,4,1,41,30,11,1,3,0,100,50.9,0,Colorado Avalanche
Edmonton Oilers,Vegas Golden Knights,2024-12-03,2,0,1,-1,28,16,12,0,0,--,--,58.8,0,Vegas Golden Knights
Vancouver Canucks,Minnesota Wild,2024-12-03,1,2,3,-1,32,29,3,3,1,33.3,100,56.5,0,Minnesota Wild
San Jose Sharks,Washington Capitals,2024-12-03,2,2,1,1,31,28,3,4,3,25,100,49.1,0,San Jose Sharks
Columbus Blue Jackets,Calgary Flames,2024-12-03,1,0,3,-3,16,22,-6,1,4,0,50,40.4,0,Calgary Flames
Minnesota Wild,Vancouver Canucks,2024-12-03,2,3,2,1,29,32,-3,1,3,0,66.7,43.5,1,Minnesota Wild
Winnipeg Jets,St. Louis Blues,2024-12-03,1,1,4,-3,23,32,-9,2,3,0,100,37.9,1,St. Louis Blues
Vegas Golden Knights,Edmonton Oilers,2024-12-03,2,1,0,1,16,28,-12,0,0,--,--,41.2,1,Vegas Golden Knights
Seattle Kraken,Carolina Hurricanes,2024-12-03,2,4,2,2,28,19,9,2,1,0,0,48.2,0,Seattle Kraken
Boston Bruins,Chicago Blackhawks,2024-12-04,0,4,2,2,27,22,5,5,2,0,100,62.5,0,Boston Bruins
Toronto Maple Leafs,Nashville Predators,2024-12-04,1,3,2,1,28,24,4,3,2,33.3,100,41.1,1,Toronto Maple Leafs
Chicago Blackhawks,Boston Bruins,2024-12-04,1,2,4,-2,22,27,-5,2,5,0,100,37.5,1,Boston Bruins
Nashville Predators,Toronto Maple Leafs,2024-12-04,3,2,3,-1,24,28,-4,2,3,0,66.7,58.9,0,Toronto Maple Leafs
Anaheim Ducks,Vegas Golden Knights,2024-12-04,2,1,4,-3,20,33,-13,1,2,0,100,32.7,1,Vegas Golden Knights
Dallas Stars,Los Angeles Kings,2024-12-04,1,2,3,-1,28,17,11,2,2,50,100,56.0,0,Los Angeles Kings
Los Angeles Kings,Dallas Stars,2024-12-04,3,3,2,1,17,28,-11,2,2,0,50,44.0,1,Los Angeles Kings
Vegas Golden Knights,Anaheim Ducks,2024-12-04,0,4,1,3,33,20,13,2,1,0,100,67.3,0,Vegas Golden Knights
New York Islanders,Seattle Kraken,2024-12-05,1,2,5,-3,29,25,4,3,2,0,0,60.4,1,Seattle Kraken
Philadelphia Flyers,Florida Panthers,2024-12-05,4,5,7,-2,34,28,6,4,5,25,20,49.2,1,Florida Panthers
Buffalo Sabres,Winnipeg Jets,2024-12-05,1,2,3,-1,30,31,-1,3,5,33.3,80,44.8,1,Winnipeg Jets
Montréal Canadiens,Nashville Predators,2024-12-05,1,3,0,3,30,29,1,3,5,33.3,100,56.0,0,Montréal Canadiens
Ottawa Senators,Detroit Red Wings,2024-12-05,3,2,1,1,32,20,12,5,3,0,66.7,52.3,1,Ottawa Senators
Carolina Hurricanes,Colorado Avalanche,2024-12-05,1,5,3,2,35,19,16,5,3,40,100,64.4,1,Carolina Hurricanes
Florida Panthers,Philadelphia Flyers,2024-12-05,1,7,5,2,28,34,-6,5,4,80,75,50.8,0,Florida Panthers
Tampa Bay Lightning,San Jose Sharks,2024-12-05,4,8,1,7,35,21,14,2,3,50,100,38.9,1,Tampa Bay Lightning
Detroit Red Wings,Ottawa Senators,2024-12-05,1,1,2,-1,20,32,-12,3,5,33.3,100,47.7,0,Ottawa Senators
Nashville Predators,Montreal Canadiens,2024-12-05,0,0,3,-3,29,30,-1,5,3,0,66.7,44.0,0,Montreal Canadiens
St. Louis Blues,Calgary Flames,2024-12-05,1,4,3,1,24,39,-15,3,4,33.3,75,53.8,0,St. Louis Blues
Calgary Flames,St. Louis Blues,2024-12-05,1,3,4,-1,39,24,15,4,3,25,66.7,46.3,1,St. Louis Blues
Colorado Avalanche,Carolina Hurricanes,2024-12-05,1,3,5,-2,19,35,-16,3,5,0,60,35.6,0,Carolina Hurricanes
Edmonton Oilers,Columbus Blue Jackets,2024-12-05,1,6,3,3,36,22,14,5,2,40,100,63.0,1,Edmonton Oilers
San Jose Sharks,Tampa Bay Lightning,2024-12-05,1,1,8,-7,21,35,-14,3,2,0,50,61.1,0,Tampa Bay Lightning
Columbus Blue Jackets,Edmonton Oilers,2024-12-05,1,3,6,-3,22,36,-14,2,5,0,60,37.0,0,Edmonton Oilers
Winnipeg Jets,Buffalo Sabres,2024-12-05,1,3,2,1,31,30,1,5,3,20,66.7,55.2,0,Winnipeg Jets
Seattle Kraken,New York Islanders,2024-12-05,1,5,2,3,25,29,-4,2,3,100,100,39.6,0,Seattle Kraken
New Jersey Devils,Seattle Kraken,2024-12-06,3,3,2,1,36,19,17,2,2,0,50,49.0,1,New Jersey Devils
New York Rangers,Pittsburgh Penguins,2024-12-06,3,4,2,2,32,22,10,3,4,0,100,64.7,1,New York Rangers
Pittsburgh Penguins,New York Rangers,2024-12-06,2,2,4,-2,22,32,-10,4,3,0,100,35.3,0,New York Rangers
Toronto Maple Leafs,Washington Capitals,2024-12-06,1,1,3,-2,21,26,-5,2,4,0,100,45.8,1,Washington Capitals
Washington Capitals,Toronto Maple Leafs,2024-12-06,2,3,1,2,26,21,5,4,2,0,100,54.2,0,Washington Capitals
Vancouver Canucks,Columbus Blue Jackets,2024-12-06,2,5,2,3,17,32,-15,2,3,50,100,59.4,1,Vancouver Canucks
Anaheim Ducks,Minnesota Wild,2024-12-06,1,1,5,-4,27,33,-6,2,3,0,66.7,41.8,1,Minnesota Wild
Dallas Stars,Vegas Golden Knights,2024-12-06,1,2,3,-1,40,28,12,2,6,0,66.7,50.0,0,Vegas Golden Knights
Columbus Blue Jackets,Vancouver Canucks,2024-12-06,0,2,5,-3,32,17,15,3,2,0,50,40.6,0,Vancouver Canucks
Minnesota Wild,Anaheim Ducks,2024-12-06,2,5,1,4,33,27,6,3,2,33.3,100,58.2,0,Minnesota Wild
Vegas Golden Knights,Dallas Stars,2024-12-06,1,3,2,1,28,40,-12,6,2,33.3,100,50.0,1,Vegas Golden Knights
Seattle Kraken,New Jersey Devils,2024-12-06,0,2,3,-1,19,36,-17,2,2,50,100,51.0,0,New Jersey Devils
New York Islanders,Carolina Hurricanes,2024-12-07,1,4,3,1,25,31,-6,2,3,0,33.3,44.8,1,New York Islanders
Philadelphia Flyers,Boston Bruins,2024-12-07,1,3,4,-1,26,31,-5,2,6,50,83.3,51.5,0,Boston Bruins
Pittsburgh Penguins,Toronto Maple Leafs,2024-12-07,0,5,2,3,29,27,2,5,3,40,66.7,64.7,1,Pittsburgh Penguins
Boston Bruins,Philadelphia Flyers,2024-12-07,2,4,3,1,31,26,5,6,2,16.7,50,48.5,1,Boston Bruins
Buffalo Sabres,Utah Hockey Club,2024-12-07,1,2,5,-3,25,28,-3,3,0,0,--,60.0,1,Utah Hockey Club
Montréal Canadiens,Washington Capitals,2024-12-07,1,2,4,-2,24,35,-11,2,3,0,66.7,49.0,0,Washington Capitals
Ottawa Senators,Nashville Predators,2024-12-07,1,3,1,2,30,37,-7,3,1,0,100,56.2,1,Ottawa Senators
Toronto Maple Leafs,Pittsburgh Penguins,2024-12-07,0,2,5,-3,27,29,-2,3,5,33.3,60,35.3,0,Pittsburgh Penguins
Carolina Hurricanes,New York Islanders,2024-12-07,1,3,4,-1,31,25,6,3,2,66.7,100,55.2,0,New York Islanders
Florida Panthers,San Jose Sharks,2024-12-07,1,3,1,2,54,29,25,5,7,20,85.7,50.8,1,Florida Panthers
Washington Capitals,Montreal Canadiens,2024-12-07,0,4,2,2,35,24,11,3,2,33.3,100,51.0,0,Washington Capitals
Chicago Blackhawks,Winnipeg Jets,2024-12-07,2,2,4,-2,14,29,-15,1,2,100,100,52.3,1,Winnipeg Jets
Detroit Red Wings,Colorado Avalanche,2024-12-07,1,1,2,-1,30,25,5,1,1,0,0,62.7,1,Colorado Avalanche
Nashville Predators,Ottawa Senators,2024-12-07,1,1,3,-2,37,30,7,1,3,0,100,43.8,0,Ottawa Senators
St. Louis Blues,Edmonton Oilers,2024-12-07,1,2,4,-2,31,21,10,2,1,50,0,43.1,0,Edmonton Oilers
Colorado Avalanche,Detroit Red Wings,2024-12-07,1,2,1,1,25,30,-5,1,1,100,100,37.3,0,Colorado Avalanche
Edmonton Oilers,St. Louis Blues,2024-12-07,1,4,2,2,21,31,-10,1,2,100,50,56.9,1,Edmonton Oilers
Los Angeles Kings,Minnesota Wild,2024-12-07,2,4,1,3,34,23,11,2,2,50,100,56.0,1,Los Angeles Kings
San Jose Sharks,Florida Panthers,2024-12-07,1,1,3,-2,29,54,-25,7,5,14.3,80,49.3,0,Florida Panthers
Minnesota Wild,Los Angeles Kings,2024-12-07,0,1,4,-3,23,34,-11,2,2,0,50,44.0,0,Los Angeles Kings
Winnipeg Jets,Chicago Blackhawks,2024-12-07,1,4,2,2,29,14,15,2,1,0,0,47.7,0,Winnipeg Jets
Utah Hockey Club,Buffalo Sabres,2024-12-07,4,5,2,3,28,25,3,0,3,--,100,40.0,0,Utah Hockey Club
New Jersey Devils,Colorado Avalanche,2024-12-08,1,0,4,-4,25,24,1,3,2,0,100,44.4,1,Colorado Avalanche
New York Islanders,Ottawa Senators,2024-12-08,0,4,2,2,13,31,-18,2,3,100,66.7,37.3,0,New York Islanders
New York Rangers,Seattle Kraken,2024-12-08,1,5,7,-2,37,22,15,2,2,50,50,62.5,1,Seattle Kraken
Philadelphia Flyers,Utah Hockey Club,2024-12-08,0,2,4,-2,24,25,-1,2,3,0,66.7,58.2,1,Utah Hockey Club
Ottawa Senators,New York Islanders,2024-12-08,0,2,4,-2,31,13,18,3,2,33.3,0,62.8,1,New York Islanders
Tampa Bay Lightning,Vancouver Canucks,2024-12-08,2,4,2,2,33,25,8,4,3,50,100,45.5,0,Tampa Bay Lightning
Calgary Flames,Dallas Stars,2024-12-08,2,2,6,-4,31,28,3,3,4,0,100,47.5,0,Dallas Stars
Colorado Avalanche,New Jersey Devils,2024-12-08,0,4,0,4,24,25,-1,2,3,0,100,55.6,0,Colorado Avalanche
Vancouver Canucks,Tampa Bay Lightning,2024-12-08,1,2,4,-2,25,33,-8,3,4,0,50,54.6,1,Tampa Bay Lightning
Dallas Stars,Calgary Flames,2024-12-08,1,6,2,4,28,31,-3,4,3,0,100,52.5,1,Dallas Stars
Columbus Blue Jackets,Winnipeg Jets,2024-12-08,1,4,1,3,28,25,3,2,4,50,75,32.6,0,Columbus Blue Jackets
Winnipeg Jets,Columbus Blue Jackets,2024-12-08,0,1,4,-3,25,28,-3,4,2,25,50,67.4,1,Columbus Blue Jackets
Seattle Kraken,New York Rangers,2024-12-08,1,7,5,2,22,37,-15,2,2,50,50,37.5,0,Seattle Kraken
Utah Hockey Club,Philadelphia Flyers,2024-12-08,0,4,2,2,25,24,1,3,2,33.3,100,41.8,0,Utah Hockey Club
New York Rangers,Chicago Blackhawks,2024-12-09,0,1,2,-1,30,32,-2,2,2,0,100,62.9,1,Chicago Blackhawks
Buffalo Sabres,Detroit Red Wings,2024-12-09,1,5,5,0,21,31,-10,2,3,0,100,44.4,1,Detroit Red Wings
Montréal Canadiens,Anaheim Ducks,2024-12-09,1,2,2,0,21,29,-8,2,3,50,66.7,50.0,0,Anaheim Ducks
Chicago Blackhawks,New York Rangers,2024-12-09,1,2,1,1,32,30,2,2,2,0,100,37.1,0,Chicago Blackhawks
Detroit Red Wings,Buffalo Sabres,2024-12-09,1,5,5,0,31,21,10,3,2,0,100,55.6,0,Buffalo Sabres
Anaheim Ducks,Montreal Canadiens,2024-12-09,2,2,2,0,29,21,8,3,2,33.3,50,50.0,0,Montreal Canadiens
New Jersey Devils,Toronto Maple Leafs,2024-12-10,1,1,2,-1,39,17,22,4,3,0,100,50.9,1,Toronto Maple Leafs
New York Islanders,Los Angeles Kings,2024-12-10,1,1,3,-2,20,30,-10,3,1,0,100,47.4,1,Los Angeles Kings
Philadelphia Flyers,Columbus Blue Jackets,2024-12-10,1,5,3,2,25,18,7,3,2,33.3,50,35.6,0,Philadelphia Flyers
Pittsburgh Penguins,Colorado Avalanche,2024-12-10,2,2,6,-4,27,27,0,4,3,0,100,61.8,1,Colorado Avalanche
Boston Bruins,Winnipeg Jets,2024-12-10,2,1,8,-7,24,35,-11,2,6,50,50,52.2,0,Winnipeg Jets
Toronto Maple Leafs,New Jersey Devils,2024-12-10,2,2,1,1,17,39,-22,3,4,0,100,49.2,0,Toronto Maple Leafs
Carolina Hurricanes,San Jose Sharks,2024-12-10,2,3,2,1,28,23,5,4,3,0,100,44.2,1,Carolina Hurricanes
Florida Panthers,Seattle Kraken,2024-12-10,2,1,1,0,33,18,15,2,3,0,100,50.0,0,Seattle Kraken
Tampa Bay Lightning,Edmonton Oilers,2024-12-10,1,1,2,-1,22,25,-3,2,2,0,100,51.7,0,Edmonton Oilers
Nashville Predators,Calgary Flames,2024-12-10,2,3,4,-1,20,28,-8,2,2,0,50,56.6,1,Calgary Flames
St. Louis Blues,Vancouver Canucks,2024-12-10,2,4,3,1,25,25,0,2,3,50,66.7,54.7,0,St. Louis Blues
Calgary Flames,Nashville Predators,2024-12-10,1,4,3,1,28,20,8,2,2,50,100,43.4,0,Calgary Flames
Colorado Avalanche,Pittsburgh Penguins,2024-12-10,1,6,2,4,27,27,0,3,4,0,100,38.2,0,Colorado Avalanche
Edmonton Oilers,Tampa Bay Lightning,2024-12-10,2,2,1,1,25,22,3,2,2,0,100,48.3,1,Edmonton Oilers
Vancouver Canucks,St. Louis Blues,2024-12-10,1,3,4,-1,25,25,0,3,2,33.3,50,45.3,1,St. Louis Blues
Los Angeles Kings,New York Islanders,2024-12-10,2,3,1,2,30,20,10,1,3,0,100,52.6,0,Los Angeles Kings
San Jose Sharks,Carolina Hurricanes,2024-12-10,2,2,3,-1,23,28,-5,3,4,0,100,55.8,0,Carolina Hurricanes
Columbus Blue Jackets,Philadelphia Flyers,2024-12-10,1,3,5,-2,18,25,-7,2,3,50,66.7,64.4,1,Philadelphia Flyers
Minnesota Wild,Utah Hockey Club,2024-12-10,2,4,4,0,38,25,13,2,3,0,33.3,47.0,0,Utah Hockey Club
Winnipeg Jets,Boston Bruins,2024-12-10,1,8,1,7,35,24,11,6,2,50,50,47.8,1,Winnipeg Jets
Seattle Kraken,Florida Panthers,2024-12-10,1,1,1,0,18,33,-15,3,2,0,100,50.0,1,Florida Panthers
Utah Hockey Club,Minnesota Wild,2024-12-10,1,4,4,0,25,38,-13,3,2,66.7,100,53.0,1,Minnesota Wild
New York Rangers,Buffalo Sabres,2024-12-11,1,3,2,1,28,31,-3,4,2,25,100,53.6,0,New York Rangers
Buffalo Sabres,New York Rangers,2024-12-11,1,2,3,-1,31,28,3,2,4,0,75,46.4,1,New York Rangers
Ottawa Senators,Anaheim Ducks,2024-12-11,2,5,1,4,34,32,2,5,5,60,100,64.8,1,Ottawa Senators
Anaheim Ducks,Ottawa Senators,2024-12-11,1,1,5,-4,32,34,-2,5,5,0,40,35.2,0,Ottawa Senators
New Jersey Devils,Los Angeles Kings,2024-12-12,1,3,1,2,26,14,12,1,1,0,100,44.0,1,New Jersey Devils
New York Islanders,Chicago Blackhawks,2024-12-12,1,5,4,1,21,30,-9,3,2,0,50,72.7,1,New York Islanders
Philadelphia Flyers,Detroit Red Wings,2024-12-12,1,4,1,3,36,26,10,1,1,0,100,63.0,1,Philadelphia Flyers
Pittsburgh Penguins,Montreal Canadiens,2024-12-12,1,9,2,7,33,23,10,3,4,66.7,100,51.0,0,Pittsburgh Penguins
Boston Bruins,Seattle Kraken,2024-12-12,1,1,5,-4,34,21,13,1,3,0,66.7,56.8,0,Seattle Kraken
Montréal Canadiens,Pittsburgh Penguins,2024-12-12,2,2,9,-7,23,33,-10,4,3,0,33.3,49.0,0,Pittsburgh Penguins
Toronto Maple Leafs,Anaheim Ducks,2024-12-12,1,3,2,1,33,28,5,2,1,0,0,57.6,1,Toronto Maple Leafs
Florida Panthers,Vancouver Canucks,2024-12-12,1,0,4,-4,27,19,8,2,1,0,0,43.9,0,Vancouver Canucks
Tampa Bay Lightning,Calgary Flames,2024-12-12,1,8,3,5,26,22,4,3,0,100,--,62.5,0,Tampa Bay Lightning
Washington Capitals,Columbus Blue Jackets,2024-12-12,4,2,1,1,37,33,4,1,5,0,80,61.3,0,Washington Capitals
Chicago Blackhawks,New York Islanders,2024-12-12,2,4,5,-1,30,21,9,2,3,50,100,27.3,0,New York Islanders
Detroit Red Wings,Philadelphia Flyers,2024-12-12,2,1,4,-3,26,36,-10,1,1,0,100,37.0,0,Philadelphia Flyers
Nashville Predators,Dallas Stars,2024-12-12,1,4,1,3,26,36,-10,1,1,0,100,38.6,0,Nashville Predators
St. Louis Blues,San Jose Sharks,2024-12-12,1,3,4,-1,20,31,-11,2,2,0,50,50.0,1,San Jose Sharks
Calgary Flames,Tampa Bay Lightning,2024-12-12,1,3,8,-5,22,26,-4,0,3,--,0,37.5,1,Tampa Bay Lightning
Colorado Avalanche,Utah Hockey Club,2024-12-12,1,1,4,-3,24,23,1,3,2,0,50,56.6,1,Utah Hockey Club
Edmonton Oilers,Minnesota Wild,2024-12-12,1,7,1,6,35,30,5,4,3,50,66.7,56.0,0,Edmonton Oilers
Vancouver Canucks,Florida Panthers,2024-12-12,1,4,0,4,19,27,-8,1,2,100,100,56.1,1,Vancouver Canucks
Anaheim Ducks,Toronto Maple Leafs,2024-12-12,0,2,3,-1,28,33,-5,1,2,100,100,42.4,0,Toronto Maple Leafs
Dallas Stars,Nashville Predators,2024-12-12,3,1,4,-3,36,26,10,1,1,0,100,61.4,1,Nashville Predators
Los Angeles Kings,New Jersey Devils,2024-12-12,1,1,3,-2,14,26,-12,1,1,0,100,56.0,0,New Jersey Devils
San Jose Sharks,St. Louis Blues,2024-12-12,1,4,3,1,31,20,11,2,2,50,100,50.0,0,San Jose Sharks
Columbus Blue Jackets,Washington Capitals,2024-12-12,1,1,2,-1,33,37,-4,5,1,20,100,38.7,1,Washington Capitals
Minnesota Wild,Edmonton Oilers,2024-12-12,1,1,7,-6,30,35,-5,3,4,33.3,50,44.0,1,Edmonton Oilers
Winnipeg Jets,Vegas Golden Knights,2024-12-12,1,2,3,-1,20,36,-16,1,4,0,75,46.0,1,Vegas Golden Knights
Vegas Golden Knights,Winnipeg Jets,2024-12-12,4,3,2,1,36,20,16,4,1,25,100,54.0,0,Vegas Golden Knights
Seattle Kraken,Boston Bruins,2024-12-12,1,5,1,4,21,34,-13,3,1,33.3,100,43.2,1,Seattle Kraken
Utah Hockey Club,Colorado Avalanche,2024-12-12,1,4,1,3,23,24,-1,2,3,50,100,43.4,0,Utah Hockey Club
Ottawa Senators,Carolina Hurricanes,2024-12-13,1,3,0,3,22,32,-10,2,2,0,100,55.1,0,Ottawa Senators
Carolina Hurricanes,Ottawa Senators,2024-12-13,2,0,3,-3,32,22,10,2,2,0,100,44.9,1,Ottawa Senators
New Jersey Devils,Chicago Blackhawks,2024-12-14,1,4,1,3,24,17,7,3,3,0,100,66.0,1,New Jersey Devils
New York Rangers,Los Angeles Kings,2024-12-14,2,1,5,-4,32,32,0,3,3,0,100,62.8,1,Los Angeles Kings
Philadelphia Flyers,Minnesota Wild,2024-12-14,1,1,4,-3,22,22,0,3,1,0,100,56.7,0,Minnesota Wild
Pittsburgh Penguins,Ottawa Senators,2024-12-14,1,2,3,-1,27,31,-4,0,2,--,100,54.0,0,Ottawa Senators
Boston Bruins,Vancouver Canucks,2024-12-14,1,5,1,4,28,20,8,4,2,25,100,49.2,0,Boston Bruins
Buffalo Sabres,Washington Capitals,2024-12-14,2,2,4,-2,21,31,-10,2,3,0,33.3,54.4,0,Washington Capitals
Montréal Canadiens,Winnipeg Jets,2024-12-14,1,2,4,-2,28,27,1,4,6,0,66.7,50.0,0,Winnipeg Jets
Ottawa Senators,Pittsburgh Penguins,2024-12-14,0,3,2,1,31,27,4,2,0,0,--,46.0,1,Ottawa Senators
Toronto Maple Leafs,Detroit Red Wings,2024-12-14,1,2,4,-2,25,26,-1,2,3,50,100,48.9,0,Detroit Red Wings
Florida Panthers,Calgary Flames,2024-12-14,1,0,3,-3,32,27,5,3,2,0,100,62.3,0,Calgary Flames
Tampa Bay Lightning,Seattle Kraken,2024-12-14,1,5,1,4,31,22,9,3,2,33.3,50,47.4,0,Tampa Bay Lightning
Washington Capitals,Buffalo Sabres,2024-12-14,1,4,2,2,31,21,10,3,2,66.7,100,45.6,1,Washington Capitals
Chicago Blackhawks,New Jersey Devils,2024-12-14,1,1,4,-3,17,24,-7,3,3,0,100,34.0,0,New Jersey Devils
Detroit Red Wings,Toronto Maple Leafs,2024-12-14,1,4,2,2,26,25,1,3,2,0,50,51.1,1,Detroit Red Wings
Nashville Predators,Colorado Avalanche,2024-12-14,1,2,5,-3,39,33,6,1,2,0,100,58.7,0,Colorado Avalanche
St. Louis Blues,Dallas Stars,2024-12-14,1,1,2,-1,16,37,-21,2,4,0,75,37.7,0,Dallas Stars
Calgary Flames,Florida Panthers,2024-12-14,1,3,0,3,27,32,-5,2,3,0,100,37.7,1,Calgary Flames
Colorado Avalanche,Nashville Predators,2024-12-14,1,5,2,3,33,39,-6,2,1,0,100,41.3,1,Colorado Avalanche
Edmonton Oilers,Vegas Golden Knights,2024-12-14,1,6,3,3,34,42,-8,2,1,50,100,42.4,1,Edmonton Oilers
Vancouver Canucks,Boston Bruins,2024-12-14,1,1,5,-4,20,28,-8,2,4,0,75,50.8,1,Boston Bruins
Anaheim Ducks,Columbus Blue Jackets,2024-12-14,1,4,3,1,27,42,-15,1,2,0,50,50.0,0,Anaheim Ducks
Dallas Stars,St. Louis Blues,2024-12-14,1,2,1,1,37,16,21,4,2,25,100,62.3,1,Dallas Stars
Los Angeles Kings,New York Rangers,2024-12-14,1,5,1,4,32,32,0,3,3,0,100,37.3,0,Los Angeles Kings
San Jose Sharks,Utah Hockey Club,2024-12-14,1,3,4,-1,22,40,-18,3,6,33.3,66.7,48.4,1,Utah Hockey Club
Columbus Blue Jackets,Anaheim Ducks,2024-12-14,1,3,4,-1,42,27,15,2,1,50,100,50.0,1,Anaheim Ducks
Minnesota Wild,Philadelphia Flyers,2024-12-14,1,4,1,3,22,22,0,1,3,0,100,43.3,1,Minnesota Wild
Winnipeg Jets,Montreal Canadiens,2024-12-14,1,4,2,2,27,28,-1,6,4,33.3,100,50.0,1,Winnipeg Jets
Vegas Golden Knights,Edmonton Oilers,2024-12-14,1,3,6,-3,42,34,8,1,2,0,50,57.6,0,Edmonton Oilers
Seattle Kraken,Tampa Bay Lightning,2024-12-14,1,1,5,-4,22,31,-9,2,3,50,66.7,52.6,1,Tampa Bay Lightning
Utah Hockey Club,San Jose Sharks,2024-12-14,1,4,3,1,40,22,18,6,3,33.3,66.7,51.6,0,Utah Hockey Club
New York Islanders,Chicago Blackhawks,2024-12-15,2,3,5,-2,33,23,10,4,2,0,50,56.0,0,Chicago Blackhawks
New York Rangers,St. Louis Blues,2024-12-15,0,2,3,-1,28,24,4,0,1,--,100,55.4,0,St. Louis Blues
Buffalo Sabres,Toronto Maple Leafs,2024-12-15,0,3,5,-2,27,41,-14,2,4,50,75,43.3,0,Toronto Maple Leafs
Toronto Maple Leafs,Buffalo Sabres,2024-12-15,0,5,3,2,41,27,14,4,2,25,50,56.7,1,Toronto Maple Leafs
Carolina Hurricanes,Columbus Blue Jackets,2024-12-15,1,4,1,3,28,28,0,3,5,0,100,61.0,1,Carolina Hurricanes
Chicago Blackhawks,New York Islanders,2024-12-15,0,5,3,2,23,33,-10,2,4,50,100,44.0,1,Chicago Blackhawks
St. Louis Blues,New York Rangers,2024-12-15,0,3,2,1,24,28,-4,1,0,0,--,44.6,1,St. Louis Blues
Columbus Blue Jackets,Carolina Hurricanes,2024-12-15,0,1,4,-3,28,28,0,5,3,0,100,39.0,0,Carolina Hurricanes
Minnesota Wild,Vegas Golden Knights,2024-12-15,0,2,3,-1,22,27,-5,1,1,0,0,45.3,1,Vegas Golden Knights
Vegas Golden Knights,Minnesota Wild,2024-12-15,0,3,2,1,27,22,5,1,1,100,100,54.7,0,Vegas Golden Knights
Florida Panthers,Edmonton Oilers,2024-12-16,1,6,5,1,28,30,-2,4,3,25,66.7,41.5,0,Florida Panthers
Washington Capitals,Dallas Stars,2024-12-16,1,1,3,-2,26,24,2,4,2,0,50,47.7,0,Dallas Stars
Colorado Avalanche,Vancouver Canucks,2024-12-16,1,1,3,-2,31,25,6,4,2,0,100,49.1,0,Vancouver Canucks
Edmonton Oilers,Florida Panthers,2024-12-16,1,5,6,-1,30,28,2,3,4,33.3,75,58.5,1,Florida Panthers
Vancouver Canucks,Colorado Avalanche,2024-12-16,1,3,1,2,25,31,-6,2,4,0,100,50.9,1,Vancouver Canucks
Dallas Stars,Washington Capitals,2024-12-16,1,3,1,2,24,26,-2,2,4,50,100,52.3,1,Dallas Stars
New Jersey Devils,St. Louis Blues,2024-12-17,2,4,1,3,28,20,8,3,1,33.3,100,61.5,0,New Jersey Devils
New York Islanders,Carolina Hurricanes,2024-12-17,1,0,4,-4,32,29,3,1,2,0,50,53.9,0,Carolina Hurricanes
New York Rangers,Nashville Predators,2024-12-17,1,0,2,-2,25,32,-7,2,2,0,100,52.6,0,Nashville Predators
Pittsburgh Penguins,Los Angeles Kings,2024-12-17,2,3,2,1,31,31,0,3,3,0,100,45.8,1,Pittsburgh Penguins
Boston Bruins,Calgary Flames,2024-12-17,2,4,3,1,35,23,12,1,0,0,--,68.0,0,Boston Bruins
Buffalo Sabres,Montreal Canadiens,2024-12-17,1,1,6,-5,21,27,-6,5,6,0,50,51.8,0,Montreal Canadiens
Montréal Canadiens,Buffalo Sabres,2024-12-17,2,6,1,5,27,21,6,6,5,50,100,48.2,0,Montréal Canadiens
Ottawa Senators,Seattle Kraken,2024-12-17,2,3,0,3,27,30,-3,3,4,0,100,54.2,0,Ottawa Senators
Carolina Hurricanes,New York Islanders,2024-12-17,1,4,0,4,29,32,-3,2,1,50,100,46.2,1,Carolina Hurricanes
Tampa Bay Lightning,Columbus Blue Jackets,2024-12-17,2,5,3,2,33,32,1,2,5,50,80,54.7,1,Tampa Bay Lightning
Washington Capitals,Chicago Blackhawks,2024-12-17,0,2,3,-1,22,23,-1,3,4,0,100,61.4,0,Chicago Blackhawks
Chicago Blackhawks,Washington Capitals,2024-12-17,1,3,2,1,23,22,1,4,3,0,100,38.6,1,Chicago Blackhawks
Nashville Predators,New York Rangers,2024-12-17,2,2,0,2,32,25,7,2,2,0,100,47.4,1,Nashville Predators
St. Louis Blues,New Jersey Devils,2024-12-17,1,1,4,-3,20,28,-8,1,3,0,66.7,38.5,1,New Jersey Devils
Calgary Flames,Boston Bruins,2024-12-17,2,3,4,-1,23,35,-12,0,1,--,100,32.0,1,Boston Bruins
Los Angeles Kings,Pittsburgh Penguins,2024-12-17,2,2,3,-1,31,31,0,3,3,0,100,54.2,0,Pittsburgh Penguins
San Jose Sharks,Winnipeg Jets,2024-12-17,2,3,4,-1,35,33,2,3,2,33.3,0,40.0,1,Winnipeg Jets
Columbus Blue Jackets,Tampa Bay Lightning,2024-12-17,1,3,5,-2,32,33,-1,5,2,20,50,45.3,0,Tampa Bay Lightning
Winnipeg Jets,San Jose Sharks,2024-12-17,2,4,3,1,33,35,-2,2,3,100,66.7,60.0,0,Winnipeg Jets
Seattle Kraken,Ottawa Senators,2024-12-17,2,0,3,-3,30,27,3,4,3,0,100,45.8,1,Ottawa Senators
Philadelphia Flyers,Detroit Red Wings,2024-12-18,3,4,6,-2,19,24,-5,1,3,0,66.7,57.5,0,Detroit Red Wings
Toronto Maple Leafs,Dallas Stars,2024-12-18,2,5,3,2,19,39,-20,1,4,0,100,53.1,0,Toronto Maple Leafs
Florida Panthers,Minnesota Wild,2024-12-18,1,6,1,5,33,27,6,2,2,50,50,53.5,0,Florida Panthers
Detroit Red Wings,Philadelphia Flyers,2024-12-18,3,6,4,2,24,19,5,3,1,33.3,100,42.6,1,Detroit Red Wings
Vancouver Canucks,Utah Hockey Club,2024-12-18,1,2,3,-1,26,31,-5,3,3,33.3,66.7,57.4,0,Utah Hockey Club
Anaheim Ducks,Winnipeg Jets,2024-12-18,3,3,2,1,31,23,8,3,4,0,75,50.0,1,Anaheim Ducks
Dallas Stars,Toronto Maple Leafs,2024-12-18,1,3,5,-2,39,19,20,4,1,0,100,46.9,1,Toronto Maple Leafs
Minnesota Wild,Florida Panthers,2024-12-18,2,1,6,-5,27,33,-6,2,2,50,50,46.6,1,Florida Panthers
Winnipeg Jets,Anaheim Ducks,2024-12-18,0,2,3,-1,23,31,-8,4,3,25,100,50.0,0,Anaheim Ducks
Utah Hockey Club,Vancouver Canucks,2024-12-18,3,3,2,1,31,26,5,3,3,33.3,66.7,42.6,1,Utah Hockey Club
New Jersey Devils,Columbus Blue Jackets,2024-12-19,1,2,4,-2,42,20,22,1,2,0,50,49.2,0,Columbus Blue Jackets
Philadelphia Flyers,Los Angeles Kings,2024-12-19,0,3,7,-4,26,27,-1,2,1,0,100,53.2,1,Los Angeles Kings
Pittsburgh Penguins,Nashville Predators,2024-12-19,1,5,4,1,20,26,-6,3,5,33.3,80,54.0,0,Pittsburgh Penguins
Boston Bruins,Edmonton Oilers,2024-12-19,1,2,3,-1,26,26,0,2,2,0,100,53.6,0,Edmonton Oilers
Ottawa Senators,Calgary Flames,2024-12-19,1,3,2,1,29,32,-3,3,2,0,50,54.1,0,Ottawa Senators
Tampa Bay Lightning,St. Louis Blues,2024-12-19,1,3,1,2,18,32,-14,3,2,0,100,44.0,1,Tampa Bay Lightning
Chicago Blackhawks,Seattle Kraken,2024-12-19,1,3,1,2,24,27,-3,2,3,0,100,42.6,1,Chicago Blackhawks
Nashville Predators,Pittsburgh Penguins,2024-12-19,1,4,5,-1,26,20,6,5,3,20,66.7,46.0,1,Pittsburgh Penguins
St. Louis Blues,Tampa Bay Lightning,2024-12-19,1,1,3,-2,32,18,14,2,3,0,100,56.0,0,Tampa Bay Lightning
Calgary Flames,Ottawa Senators,2024-12-19,1,2,3,-1,32,29,3,2,3,50,100,45.9,1,Ottawa Senators
Colorado Avalanche,San Jose Sharks,2024-12-19,2,4,2,2,31,34,-3,4,4,50,100,51.5,0,Colorado Avalanche
Edmonton Oilers,Boston Bruins,2024-12-19,2,3,2,1,26,26,0,2,2,0,100,46.4,1,Edmonton Oilers
Vancouver Canucks,Vegas Golden Knights,2024-12-19,0,1,3,-2,20,21,-1,2,1,0,100,48.7,0,Vegas Golden Knights
Los Angeles Kings,Philadelphia Flyers,2024-12-19,1,7,3,4,27,26,1,1,2,0,100,46.8,0,Los Angeles Kings
San Jose Sharks,Colorado Avalanche,2024-12-19,1,2,4,-2,34,31,3,4,4,0,50,48.5,1,Colorado Avalanche
Columbus Blue Jackets,New Jersey Devils,2024-12-19,1,4,2,2,20,42,-22,2,1,50,100,50.9,1,Columbus Blue Jackets
Vegas Golden Knights,Vancouver Canucks,2024-12-19,3,3,1,2,21,20,1,1,2,0,100,51.3,1,Vegas Golden Knights
Seattle Kraken,Chicago Blackhawks,2024-12-19,1,1,3,-2,27,24,3,3,2,0,100,57.4,0,Chicago Blackhawks
New York Rangers,Dallas Stars,2024-12-20,2,3,1,2,30,42,-12,3,7,0,100,57.4,0,New York Rangers
Buffalo Sabres,Toronto Maple Leafs,2024-12-20,2,3,6,-3,27,29,-2,2,3,0,66.7,42.6,1,Toronto Maple Leafs
Montréal Canadiens,Detroit Red Wings,2024-12-20,2,4,3,1,33,28,5,2,4,50,100,50.0,0,Montréal Canadiens
Toronto Maple Leafs,Buffalo Sabres,2024-12-20,1,6,3,3,29,27,2,3,2,33.3,100,57.5,0,Toronto Maple Leafs
Carolina Hurricanes,Washington Capitals,2024-12-20,2,1,3,-2,25,22,3,2,2,0,100,55.4,0,Washington Capitals
Florida Panthers,St. Louis Blues,2024-12-20,1,2,1,1,27,27,0,2,2,50,100,49.1,1,Florida Panthers
Washington Capitals,Carolina Hurricanes,2024-12-20,2,3,1,2,22,25,-3,2,2,0,100,44.6,1,Washington Capitals
Detroit Red Wings,Montreal Canadiens,2024-12-20,1,3,4,-1,28,33,-5,4,2,0,50,50.0,1,Montreal Canadiens
St. Louis Blues,Florida Panthers,2024-12-20,0,1,2,-1,27,27,0,2,2,0,50,50.9,0,Florida Panthers
Colorado Avalanche,Anaheim Ducks,2024-12-20,0,4,2,2,23,32,-9,4,5,25,100,47.2,0,Colorado Avalanche
Anaheim Ducks,Colorado Avalanche,2024-12-20,1,2,4,-2,32,23,9,5,4,0,75,52.8,1,Colorado Avalanche
Dallas Stars,New York Rangers,2024-12-20,1,1,3,-2,42,30,12,7,3,0,100,42.6,1,New York Rangers
Minnesota Wild,Utah Hockey Club,2024-12-20,1,1,2,-1,29,18,11,5,3,0,66.7,37.0,1,Utah Hockey Club
Utah Hockey Club,Minnesota Wild,2024-12-20,1,2,1,1,18,29,-11,3,5,33.3,100,63.0,0,Utah Hockey Club
New Jersey Devils,Pittsburgh Penguins,2024-12-21,1,3,0,3,27,12,15,1,2,0,100,51.9,1,New Jersey Devils
New York Islanders,Toronto Maple Leafs,2024-12-21,3,6,3,3,34,29,5,0,0,--,--,64.7,0,New York Islanders
Philadelphia Flyers,Columbus Blue Jackets,2024-12-21,1,5,4,1,30,25,5,3,1,0,100,47.5,1,Philadelphia Flyers
Pittsburgh Penguins,New Jersey Devils,2024-12-21,1,0,3,-3,12,27,-15,2,1,0,100,48.1,0,New Jersey Devils
Boston Bruins,Buffalo Sabres,2024-12-21,1,3,1,2,19,20,-1,3,3,33.3,66.7,60.0,1,Boston Bruins
Buffalo Sabres,Boston Bruins,2024-12-21,0,1,3,-2,20,19,1,3,3,33.3,66.7,40.0,0,Boston Bruins
Montréal Canadiens,Detroit Red Wings,2024-12-21,0,5,1,4,24,21,3,5,4,20,100,57.1,0,Montréal Canadiens
Ottawa Senators,Vancouver Canucks,2024-12-21,1,5,4,1,22,25,-3,4,2,0,100,59.6,0,Ottawa Senators
Toronto Maple Leafs,New York Islanders,2024-12-21,0,3,6,-3,29,34,-5,0,0,--,--,35.3,1,New York Islanders
Chicago Blackhawks,Calgary Flames,2024-12-21,1,4,6,-2,28,30,-2,3,5,33.3,80,54.6,0,Calgary Flames
Detroit Red Wings,Montreal Canadiens,2024-12-21,0,1,5,-4,21,24,-3,4,5,0,80,42.9,0,Montreal Canadiens
Nashville Predators,Los Angeles Kings,2024-12-21,1,3,2,1,26,24,2,2,1,0,100,52.2,1,Nashville Predators
Calgary Flames,Chicago Blackhawks,2024-12-21,1,6,4,2,30,28,2,5,3,20,66.7,45.5,1,Calgary Flames
Edmonton Oilers,San Jose Sharks,2024-12-21,1,3,2,1,42,22,20,2,1,0,100,58.3,1,Edmonton Oilers
Vancouver Canucks,Ottawa Senators,2024-12-21,1,4,5,-1,25,22,3,2,4,0,100,40.4,1,Ottawa Senators
Los Angeles Kings,Nashville Predators,2024-12-21,1,2,3,-1,24,26,-2,1,2,0,100,47.8,0,Nashville Predators
San Jose Sharks,Edmonton Oilers,2024-12-21,1,2,3,-1,22,42,-20,1,2,0,100,41.7,0,Edmonton Oilers
Columbus Blue Jackets,Philadelphia Flyers,2024-12-21,1,4,5,-1,25,30,-5,1,3,0,100,52.5,0,Philadelphia Flyers
Minnesota Wild,Winnipeg Jets,2024-12-21,0,0,5,-5,19,24,-5,4,5,0,60,48.0,0,Winnipeg Jets
Winnipeg Jets,Minnesota Wild,2024-12-21,2,5,0,5,24,19,5,5,4,40,100,52.0,1,Winnipeg Jets
Vegas Golden Knights,Seattle Kraken,2024-12-21,1,6,2,4,34,23,11,1,4,0,50,46.2,1,Vegas Golden Knights
Seattle Kraken,Vegas Golden Knights,2024-12-21,1,2,6,-4,23,34,-11,4,1,50,100,53.9,0,Vegas Golden Knights
New York Rangers,Carolina Hurricanes,2024-12-22,1,1,3,-2,23,33,-10,4,5,0,80,48.2,1,Carolina Hurricanes
Ottawa Senators,Edmonton Oilers,2024-12-22,0,1,3,-2,21,21,0,1,5,0,80,60.4,0,Edmonton Oilers
Carolina Hurricanes,New York Rangers,2024-12-22,1,3,1,2,33,23,10,5,4,20,100,51.9,0,Carolina Hurricanes
Florida Panthers,Tampa Bay Lightning,2024-12-22,1,4,2,2,26,21,5,2,3,50,100,47.4,0,Florida Panthers
Tampa Bay Lightning,Florida Panthers,2024-12-22,2,2,4,-2,21,26,-5,3,2,0,50,52.6,1,Florida Panthers
Washington Capitals,Los Angeles Kings,2024-12-22,1,3,1,2,21,26,-5,1,1,100,0,67.3,1,Washington Capitals
Colorado Avalanche,Seattle Kraken,2024-12-22,1,5,2,3,29,19,10,4,1,25,100,50.9,1,Colorado Avalanche
Edmonton Oilers,Ottawa Senators,2024-12-22,0,3,1,2,21,21,0,5,1,20,100,39.6,1,Edmonton Oilers
Anaheim Ducks,Utah Hockey Club,2024-12-22,1,4,4,0,30,25,5,6,5,16.7,80,44.6,0,Utah Hockey Club
Los Angeles Kings,Washington Capitals,2024-12-22,0,1,3,-2,26,21,5,1,1,100,0,32.7,0,Washington Capitals
Seattle Kraken,Colorado Avalanche,2024-12-22,0,2,5,-3,19,29,-10,1,4,0,75,49.1,0,Colorado Avalanche
Utah Hockey Club,Anaheim Ducks,2024-12-22,1,4,4,0,25,30,-5,5,6,20,83.3,55.4,1,Anaheim Ducks
New Jersey Devils,New York Rangers,2024-12-23,1,5,0,5,30,12,18,4,4,75,100,45.0,1,New Jersey Devils
New York Islanders,Buffalo Sabres,2024-12-23,1,1,7,-6,28,25,3,1,3,0,66.7,57.8,1,Buffalo Sabres
New York Rangers,New Jersey Devils,2024-12-23,0,0,5,-5,12,30,-18,4,4,0,25,55.0,0,New Jersey Devils
Philadelphia Flyers,Pittsburgh Penguins,2024-12-23,1,3,7,-4,27,22,5,0,3,--,0,40.8,0,Pittsburgh Penguins
Pittsburgh Penguins,Philadelphia Flyers,2024-12-23,1,7,3,4,22,27,-5,3,0,100,--,59.2,1,Pittsburgh Penguins
Boston Bruins,Washington Capitals,2024-12-23,1,4,1,3,22,11,11,4,3,25,66.7,66.0,1,Boston Bruins
Buffalo Sabres,New York Islanders,2024-12-23,1,7,1,6,25,28,-3,3,1,33.3,100,42.2,0,Buffalo Sabres
Montréal Canadiens,Columbus Blue Jackets,2024-12-23,1,4,5,-1,31,32,-1,2,3,0,66.7,53.0,0,Columbus Blue Jackets
Toronto Maple Leafs,Winnipeg Jets,2024-12-23,1,2,5,-3,25,27,-2,3,2,33.3,50,53.1,1,Winnipeg Jets
Carolina Hurricanes,Nashville Predators,2024-12-23,0,2,5,-3,27,25,2,1,2,0,50,49.1,0,Nashville Predators
Florida Panthers,Tampa Bay Lightning,2024-12-23,0,0,4,-4,36,29,7,4,3,0,66.7,47.5,1,Tampa Bay Lightning
Tampa Bay Lightning,Florida Panthers,2024-12-23,0,4,0,4,29,36,-7,3,4,33.3,100,52.5,0,Tampa Bay Lightning
Washington Capitals,Boston Bruins,2024-12-23,0,1,4,-3,11,22,-11,3,4,33.3,75,34.0,0,Boston Bruins
Chicago Blackhawks,Minnesota Wild,2024-12-23,1,3,4,-1,31,27,4,0,1,--,100,50.0,0,Minnesota Wild
Detroit Red Wings,St. Louis Blues,2024-12-23,1,0,4,-4,19,21,-2,1,2,0,100,52.0,1,St. Louis Blues
Nashville Predators,Carolina Hurricanes,2024-12-23,1,5,2,3,25,27,-2,2,1,50,100,50.9,1,Nashville Predators
St. Louis Blues,Detroit Red Wings,2024-12-23,2,4,0,4,21,19,2,2,1,0,100,48.0,0,St. Louis Blues
Vancouver Canucks,San Jose Sharks,2024-12-23,1,4,3,1,24,29,-5,5,3,20,66.7,59.3,1,Vancouver Canucks
Anaheim Ducks,Vegas Golden Knights,2024-12-23,0,1,3,-2,32,33,-1,4,3,0,100,50.0,0,Vegas Golden Knights
Dallas Stars,Utah Hockey Club,2024-12-23,2,3,2,1,29,26,3,3,2,0,100,55.4,0,Dallas Stars
San Jose Sharks,Vancouver Canucks,2024-12-23,1,3,4,-1,29,24,5,3,5,33.3,80,40.7,0,Vancouver Canucks
Columbus Blue Jackets,Montreal Canadiens,2024-12-23,1,5,4,1,32,31,1,3,2,33.3,100,47.0,1,Columbus Blue Jackets
Minnesota Wild,Chicago Blackhawks,2024-12-23,1,4,3,1,27,31,-4,1,0,0,--,50.0,1,Minnesota Wild
Winnipeg Jets,Toronto Maple Leafs,2024-12-23,1,5,2,3,27,25,2,2,3,50,66.7,46.9,0,Winnipeg Jets
Vegas Golden Knights,Anaheim Ducks,2024-12-23,1,3,1,2,33,32,1,3,4,0,100,50.0,1,Vegas Golden Knights
Utah Hockey Club,Dallas Stars,2024-12-23,0,2,3,-1,26,29,-3,2,3,0,100,44.6,1,Dallas Stars
New Jersey Devils,Carolina Hurricanes,2024-12-27,3,4,2,2,23,31,-8,0,2,--,100,58.8,1,New Jersey Devils
Boston Bruins,Columbus Blue Jackets,2024-12-27,3,2,6,-4,26,33,-7,2,3,0,0,55.6,0,Columbus Blue Jackets
Buffalo Sabres,Chicago Blackhawks,2024-12-27,3,6,2,4,35,17,18,1,1,0,100,51.0,1,Buffalo Sabres
Toronto Maple Leafs,Detroit Red Wings,2024-12-27,3,5,2,3,23,25,-2,3,3,33.3,66.7,41.9,0,Toronto Maple Leafs
Carolina Hurricanes,New Jersey Devils,2024-12-27,3,2,4,-2,31,23,8,2,0,0,--,41.2,0,New Jersey Devils
Chicago Blackhawks,Buffalo Sabres,2024-12-27,3,2,6,-4,17,35,-18,1,1,0,100,49.0,0,Buffalo Sabres
Detroit Red Wings,Toronto Maple Leafs,2024-12-27,3,2,5,-3,25,23,2,3,3,33.3,66.7,58.1,1,Toronto Maple Leafs
Nashville Predators,St. Louis Blues,2024-12-27,3,4,7,-3,30,30,0,4,4,50,75,47.6,0,St. Louis Blues
St. Louis Blues,Nashville Predators,2024-12-27,3,7,4,3,30,30,0,4,4,25,50,52.4,1,St. Louis Blues
Colorado Avalanche,Utah Hockey Club,2024-12-27,4,4,1,3,37,35,2,2,3,0,66.7,48.5,0,Colorado Avalanche
Dallas Stars,Minnesota Wild,2024-12-27,3,2,3,-1,29,18,11,3,1,0,100,48.2,1,Minnesota Wild
San Jose Sharks,Vegas Golden Knights,2024-12-27,3,3,6,-3,25,36,-11,3,2,0,100,53.5,1,Vegas Golden Knights
Columbus Blue Jackets,Boston Bruins,2024-12-27,3,6,2,4,33,26,7,3,2,100,100,44.4,1,Columbus Blue Jackets
Minnesota Wild,Dallas Stars,2024-12-27,3,3,2,1,18,29,-11,1,3,0,100,51.9,0,Minnesota Wild
Vegas Golden Knights,San Jose Sharks,2024-12-27,3,6,3,3,36,25,11,2,3,0,100,46.6,0,Vegas Golden Knights
Utah Hockey Club,Colorado Avalanche,2024-12-27,3,1,4,-3,35,37,-2,3,2,33.3,100,51.5,1,Colorado Avalanche
New Jersey Devils,Carolina Hurricanes,2024-12-28,0,2,5,-3,23,41,-18,2,4,0,75,39.0,0,Carolina Hurricanes
New York Islanders,Pittsburgh Penguins,2024-12-28,4,6,3,3,34,25,9,2,4,0,75,54.8,1,New York Islanders
New York Rangers,Tampa Bay Lightning,2024-12-28,4,2,6,-4,44,25,19,4,5,0,60,52.0,0,Tampa Bay Lightning
Philadelphia Flyers,Anaheim Ducks,2024-12-28,4,3,1,2,25,33,-8,5,4,0,100,55.4,0,Philadelphia Flyers
Pittsburgh Penguins,New York Islanders,2024-12-28,4,3,6,-3,25,34,-9,4,2,25,100,45.2,0,New York Islanders
Boston Bruins,Columbus Blue Jackets,2024-12-28,0,4,0,4,28,18,10,2,3,0,100,51.1,1,Boston Bruins
Montréal Canadiens,Florida Panthers,2024-12-28,4,4,0,4,25,34,-9,1,1,0,100,39.6,0,Montréal Canadiens
Ottawa Senators,Winnipeg Jets,2024-12-28,4,2,4,-2,35,23,12,4,3,50,66.7,60.9,0,Winnipeg Jets
Toronto Maple Leafs,Washington Capitals,2024-12-28,0,2,5,-3,37,32,5,2,1,0,0,52.7,1,Washington Capitals
Carolina Hurricanes,New Jersey Devils,2024-12-28,0,5,2,3,41,23,18,4,2,25,100,61.0,1,Carolina Hurricanes
Florida Panthers,Montreal Canadiens,2024-12-28,4,0,4,-4,34,25,9,1,1,0,100,60.4,1,Montreal Canadiens
Tampa Bay Lightning,New York Rangers,2024-12-28,4,6,2,4,25,44,-19,5,4,40,100,48.1,1,Tampa Bay Lightning
Washington Capitals,Toronto Maple Leafs,2024-12-28,4,5,2,3,32,37,-5,1,2,100,100,47.3,0,Washington Capitals
Calgary Flames,San Jose Sharks,2024-12-28,4,3,1,2,33,22,11,3,2,33.3,50,47.3,0,Calgary Flames
Edmonton Oilers,Los Angeles Kings,2024-12-28,4,3,4,-1,27,29,-2,2,1,50,100,45.9,0,Los Angeles Kings
Vancouver Canucks,Seattle Kraken,2024-12-28,4,4,5,-1,22,29,-7,2,3,50,100,53.1,1,Seattle Kraken
Anaheim Ducks,Philadelphia Flyers,2024-12-28,4,1,3,-2,33,25,8,4,5,0,100,44.6,1,Philadelphia Flyers
Los Angeles Kings,Edmonton Oilers,2024-12-28,4,4,3,1,29,27,2,1,2,0,50,54.1,1,Los Angeles Kings
San Jose Sharks,Calgary Flames,2024-12-28,0,1,3,-2,22,33,-11,2,3,50,66.7,52.7,1,Calgary Flames
Columbus Blue Jackets,Boston Bruins,2024-12-28,0,0,4,-4,18,28,-10,3,2,0,100,48.9,0,Boston Bruins
Winnipeg Jets,Ottawa Senators,2024-12-28,4,4,2,2,23,35,-12,3,4,33.3,50,39.1,1,Winnipeg Jets
Seattle Kraken,Vancouver Canucks,2024-12-28,4,5,4,1,29,22,7,3,2,0,50,46.9,0,Seattle Kraken
New York Islanders,Pittsburgh Penguins,2024-12-29,0,2,3,-1,31,41,-10,2,2,0,0,50.8,0,Pittsburgh Penguins
Philadelphia Flyers,Los Angeles Kings,2024-12-29,0,4,5,-1,21,20,1,1,1,0,0,50.0,0,Los Angeles Kings
Pittsburgh Penguins,New York Islanders,2024-12-29,0,3,2,1,41,31,10,2,2,100,100,49.3,1,Pittsburgh Penguins
Buffalo Sabres,St. Louis Blues,2024-12-29,1,4,2,2,16,37,-21,3,4,66.7,100,40.0,0,Buffalo Sabres
Montréal Canadiens,Tampa Bay Lightning,2024-12-29,0,5,2,3,37,23,14,2,3,0,100,53.1,0,Montréal Canadiens
Ottawa Senators,Minnesota Wild,2024-12-29,0,3,1,2,37,31,6,2,2,50,100,49.2,0,Ottawa Senators
Tampa Bay Lightning,Montreal Canadiens,2024-12-29,0,2,5,-3,23,37,-14,3,2,0,100,46.9,1,Montreal Canadiens
Washington Capitals,Detroit Red Wings,2024-12-29,0,2,4,-2,27,27,0,3,4,0,75,47.2,0,Detroit Red Wings
Chicago Blackhawks,Dallas Stars,2024-12-29,1,1,5,-4,25,35,-10,4,7,25,85.7,41.5,1,Dallas Stars
Detroit Red Wings,Washington Capitals,2024-12-29,1,4,2,2,27,27,0,4,3,25,100,52.8,1,Detroit Red Wings
St. Louis Blues,Buffalo Sabres,2024-12-29,1,2,4,-2,37,16,21,4,3,0,33.3,60.0,1,Buffalo Sabres
Calgary Flames,Vegas Golden Knights,2024-12-29,0,0,3,-3,31,37,-6,4,4,0,75,50.8,0,Vegas Golden Knights
Edmonton Oilers,Anaheim Ducks,2024-12-29,0,3,5,-2,23,32,-9,3,5,66.7,100,40.0,0,Anaheim Ducks
Anaheim Ducks,Edmonton Oilers,2024-12-29,0,5,3,2,32,23,9,5,3,0,33.3,60.0,1,Anaheim Ducks
Dallas Stars,Chicago Blackhawks,2024-12-29,1,5,1,4,35,25,10,7,4,14.3,75,58.5,0,Dallas Stars
Los Angeles Kings,Philadelphia Flyers,2024-12-29,0,5,4,1,20,21,-1,1,1,100,100,50.0,1,Los Angeles Kings
Minnesota Wild,Ottawa Senators,2024-12-29,1,1,3,-2,31,37,-6,2,2,0,50,50.8,1,Ottawa Senators
Vegas Golden Knights,Calgary Flames,2024-12-29,1,3,0,3,37,31,6,4,4,25,100,49.2,1,Vegas Golden Knights
New York Rangers,Florida Panthers,2024-12-30,1,3,5,-2,35,26,9,5,4,20,100,45.1,0,Florida Panthers
Florida Panthers,New York Rangers,2024-12-30,1,5,3,2,26,35,-9,4,5,0,80,54.9,1,Florida Panthers
Nashville Predators,Winnipeg Jets,2024-12-30,2,0,3,-3,22,28,-6,2,5,0,60,44.4,0,Winnipeg Jets
Winnipeg Jets,Nashville Predators,2024-12-30,1,3,0,3,28,22,6,5,2,40,100,55.6,1,Winnipeg Jets
Seattle Kraken,Utah Hockey Club,2024-12-30,1,5,2,3,33,30,3,2,1,0,0,50.9,1,Seattle Kraken
Utah Hockey Club,Seattle Kraken,2024-12-30,2,2,5,-3,30,33,-3,1,2,100,100,49.2,0,Seattle Kraken
New Jersey Devils,Anaheim Ducks,2024-12-31,2,2,3,-1,34,26,8,2,3,0,100,54.4,0,Anaheim Ducks
New York Islanders,Toronto Maple Leafs,2024-12-31,1,1,3,-2,31,25,6,1,4,0,75,53.7,0,Toronto Maple Leafs
Philadelphia Flyers,San Jose Sharks,2024-12-31,1,4,0,4,34,22,12,3,1,33.3,100,46.2,0,Philadelphia Flyers
Pittsburgh Penguins,Detroit Red Wings,2024-12-31,1,2,4,-2,25,25,0,3,3,33.3,33.3,43.8,0,Detroit Red Wings
Boston Bruins,Washington Capitals,2024-12-31,2,1,3,-2,27,27,0,2,2,0,50,52.4,0,Washington Capitals
Buffalo Sabres,Dallas Stars,2024-12-31,1,2,4,-2,23,33,-10,0,1,--,100,26.5,0,Dallas Stars
Montréal Canadiens,Vegas Golden Knights,2024-12-31,1,3,2,1,22,29,-7,0,1,--,100,58.5,0,Montréal Canadiens
Toronto Maple Leafs,New York Islanders,2024-12-31,2,3,1,2,25,31,-6,4,1,25,100,46.3,1,Toronto Maple Leafs
Carolina Hurricanes,Columbus Blue Jackets,2024-12-31,2,3,3,0,35,28,7,4,3,25,66.7,41.1,0,Columbus Blue Jackets
Washington Capitals,Boston Bruins,2024-12-31,1,3,1,2,27,27,0,2,2,50,100,47.6,1,Washington Capitals
Chicago Blackhawks,St. Louis Blues,2024-12-31,1,2,6,-4,30,28,2,4,3,50,33.3,47.3,1,St. Louis Blues
Detroit Red Wings,Pittsburgh Penguins,2024-12-31,1,4,2,2,25,25,0,3,3,66.7,66.7,56.3,1,Detroit Red Wings
Nashville Predators,Minnesota Wild,2024-12-31,0,3,5,-2,46,38,8,1,6,0,50,43.8,0,Minnesota Wild
St. Louis Blues,Chicago Blackhawks,2024-12-31,1,6,2,4,28,30,-2,3,4,66.7,50,52.7,0,St. Louis Blues
Calgary Flames,Vancouver Canucks,2024-12-31,1,3,1,2,29,24,5,2,2,0,50,47.7,1,Calgary Flames
Colorado Avalanche,Winnipeg Jets,2024-12-31,3,5,2,3,38,22,16,1,0,0,--,51.3,1,Colorado Avalanche
Edmonton Oilers,Utah Hockey Club,2024-12-31,1,4,1,3,38,27,11,3,2,0,100,54.4,1,Edmonton Oilers
Vancouver Canucks,Calgary Flames,2024-12-31,2,1,3,-2,24,29,-5,2,2,50,100,52.3,0,Calgary Flames
Anaheim Ducks,New Jersey Devils,2024-12-31,1,3,2,1,26,34,-8,3,2,0,100,45.6,1,Anaheim Ducks
Dallas Stars,Buffalo Sabres,2024-12-31,1,4,2,2,33,23,10,1,0,0,--,73.5,1,Dallas Stars
San Jose Sharks,Philadelphia Flyers,2024-12-31,2,0,4,-4,22,34,-12,1,3,0,66.7,53.9,1,Philadelphia Flyers
Columbus Blue Jackets,Carolina Hurricanes,2024-12-31,2,3,3,0,28,35,-7,3,4,33.3,75,58.9,1,Carolina Hurricanes
Minnesota Wild,Nashville Predators,2024-12-31,1,5,3,2,38,46,-8,6,1,50,100,56.3,1,Minnesota Wild
Winnipeg Jets,Colorado Avalanche,2024-12-31,0,2,5,-3,22,38,-16,0,1,--,100,48.7,0,Colorado Avalanche
Vegas Golden Knights,Montreal Canadiens,2024-12-31,1,2,3,-1,29,22,7,1,0,0,--,41.5,1,Montreal Canadiens
Utah Hockey Club,Edmonton Oilers,2024-12-31,0,1,4,-3,27,38,-11,2,3,0,100,45.7,0,Edmonton Oilers
New Jersey Devils,Los Angeles Kings,2025-01-01,0,0,3,-3,33,24,9,6,3,0,100,62.5,0,Los Angeles Kings
Los Angeles Kings,New Jersey Devils,2025-01-01,2,3,0,3,24,33,-9,3,6,0,100,37.5,1,Los Angeles Kings
New York Islanders,Toronto Maple Leafs,2025-01-02,1,1,2,-1,33,31,2,3,2,0,50,43.4,1,Toronto Maple Leafs
New York Rangers,Boston Bruins,2025-01-02,2,2,1,1,27,33,-6,1,1,0,100,48.4,1,New York Rangers
Philadelphia Flyers,Vegas Golden Knights,2025-01-02,1,2,5,-3,25,27,-2,2,1,50,100,42.6,0,Vegas Golden Knights
Boston Bruins,New York Rangers,2025-01-02,1,1,2,-1,33,27,6,1,1,0,100,51.6,0,New York Rangers
Buffalo Sabres,Colorado Avalanche,2025-01-02,1,5,6,-1,21,29,-8,3,3,66.7,66.7,55.2,0,Colorado Avalanche
Ottawa Senators,Dallas Stars,2025-01-02,3,2,4,-2,13,25,-12,4,5,0,80,40.0,0,Dallas Stars
Toronto Maple Leafs,New York Islanders,2025-01-02,1,2,1,1,31,33,-2,2,3,50,100,56.6,0,Toronto Maple Leafs
Carolina Hurricanes,Florida Panthers,2025-01-02,1,3,1,2,40,26,14,3,2,0,100,49.3,0,Carolina Hurricanes
Florida Panthers,Carolina Hurricanes,2025-01-02,2,1,3,-2,26,40,-14,2,3,0,100,50.7,1,Carolina Hurricanes
Tampa Bay Lightning,San Jose Sharks,2025-01-02,3,1,2,-1,25,25,0,2,2,0,100,55.3,0,San Jose Sharks
Washington Capitals,Minnesota Wild,2025-01-02,1,3,3,0,31,33,-2,3,2,33.3,100,63.6,1,Minnesota Wild
Detroit Red Wings,Columbus Blue Jackets,2025-01-02,1,5,4,1,26,25,1,3,2,66.7,50,49.0,0,Detroit Red Wings
Calgary Flames,Utah Hockey Club,2025-01-02,1,3,5,-2,26,26,0,4,3,25,66.7,45.8,1,Utah Hockey Club
Colorado Avalanche,Buffalo Sabres,2025-01-02,1,6,5,1,29,21,8,3,3,33.3,33.3,44.8,1,Colorado Avalanche
Vancouver Canucks,Seattle Kraken,2025-01-02,1,3,3,0,22,27,-5,2,2,0,50,52.6,0,Seattle Kraken
Anaheim Ducks,Winnipeg Jets,2025-01-02,1,4,3,1,24,30,-6,0,2,--,100,36.0,0,Anaheim Ducks
Dallas Stars,Ottawa Senators,2025-01-02,1,4,2,2,25,13,12,5,4,20,100,60.0,1,Dallas Stars
San Jose Sharks,Tampa Bay Lightning,2025-01-02,1,2,1,1,25,25,0,2,2,0,100,44.7,1,San Jose Sharks
Columbus Blue Jackets,Detroit Red Wings,2025-01-02,1,4,5,-1,25,26,-1,2,3,50,33.3,51.0,1,Detroit Red Wings
Minnesota Wild,Washington Capitals,2025-01-02,1,3,3,0,33,31,2,2,3,0,66.7,36.4,0,Washington Capitals
Winnipeg Jets,Anaheim Ducks,2025-01-02,1,3,4,-1,30,24,6,2,0,0,--,64.0,1,Anaheim Ducks
Vegas Golden Knights,Philadelphia Flyers,2025-01-02,1,5,2,3,27,25,2,1,2,0,50,57.5,1,Vegas Golden Knights
Seattle Kraken,Vancouver Canucks,2025-01-02,2,3,3,0,27,22,5,2,2,50,100,47.4,1,Vancouver Canucks
Utah Hockey Club,Calgary Flames,2025-01-02,1,5,3,2,26,26,0,3,4,33.3,75,54.2,0,Utah Hockey Club
